,Tf,In_Degree,Out_Degree,Total_Connections,file
0,ARF1,76,25,101,MM1.H3K27ac_DEGREE_TABLE.txt
1,ARID3A,86,78,164,MM1.H3K27ac_DEGREE_TABLE.txt
2,ATF5,77,86,163,MM1.H3K27ac_DEGREE_TABLE.txt
3,BACH1,82,71,153,MM1.H3K27ac_DEGREE_TABLE.txt
4,BCL6,69,93,162,MM1.H3K27ac_DEGREE_TABLE.txt
5,BCLAF1,77,91,168,MM1.H3K27ac_DEGREE_TABLE.txt
6,BHLHA15,74,76,150,MM1.H3K27ac_DEGREE_TABLE.txt
7,BHLHE41,92,46,138,MM1.H3K27ac_DEGREE_TABLE.txt
8,CEBPB,76,78,154,MM1.H3K27ac_DEGREE_TABLE.txt
9,CEBPG,57,85,142,MM1.H3K27ac_DEGREE_TABLE.txt
10,CHD2,88,89,177,MM1.H3K27ac_DEGREE_TABLE.txt
11,CREB3L2,91,77,168,MM1.H3K27ac_DEGREE_TABLE.txt
12,DBP,87,85,172,MM1.H3K27ac_DEGREE_TABLE.txt
13,DDIT3,84,78,162,MM1.H3K27ac_DEGREE_TABLE.txt
14,DEAF1,75,82,157,MM1.H3K27ac_DEGREE_TABLE.txt
15,DMRT2,78,69,147,MM1.H3K27ac_DEGREE_TABLE.txt
16,ERF,90,68,158,MM1.H3K27ac_DEGREE_TABLE.txt
17,ESR1,57,92,149,MM1.H3K27ac_DEGREE_TABLE.txt
18,ESRRA,67,92,159,MM1.H3K27ac_DEGREE_TABLE.txt
19,ETV6,76,84,160,MM1.H3K27ac_DEGREE_TABLE.txt
20,FLI1,90,89,179,MM1.H3K27ac_DEGREE_TABLE.txt
21,FOXD4L5,83,74,157,MM1.H3K27ac_DEGREE_TABLE.txt
22,FOXN3,89,72,161,MM1.H3K27ac_DEGREE_TABLE.txt
23,FOXO3,80,93,173,MM1.H3K27ac_DEGREE_TABLE.txt
24,FOXP1,76,91,167,MM1.H3K27ac_DEGREE_TABLE.txt
25,FOXP2,77,87,164,MM1.H3K27ac_DEGREE_TABLE.txt
26,HEY2,83,64,147,MM1.H3K27ac_DEGREE_TABLE.txt
27,HIVEP2,84,80,164,MM1.H3K27ac_DEGREE_TABLE.txt
28,IKZF1,92,85,177,MM1.H3K27ac_DEGREE_TABLE.txt
29,IKZF3,91,93,184,MM1.H3K27ac_DEGREE_TABLE.txt
30,IRF1,92,92,184,MM1.H3K27ac_DEGREE_TABLE.txt
31,IRF2,92,80,172,MM1.H3K27ac_DEGREE_TABLE.txt
32,IRF4,91,83,174,MM1.H3K27ac_DEGREE_TABLE.txt
33,JUN,72,84,156,MM1.H3K27ac_DEGREE_TABLE.txt
34,JUNB,88,85,173,MM1.H3K27ac_DEGREE_TABLE.txt
35,JUND,69,93,162,MM1.H3K27ac_DEGREE_TABLE.txt
36,KLF13,92,64,156,MM1.H3K27ac_DEGREE_TABLE.txt
37,KLF2,83,87,170,MM1.H3K27ac_DEGREE_TABLE.txt
38,KLF3,81,89,170,MM1.H3K27ac_DEGREE_TABLE.txt
39,KLF6,87,82,169,MM1.H3K27ac_DEGREE_TABLE.txt
40,KLF7,71,93,164,MM1.H3K27ac_DEGREE_TABLE.txt
41,KLF9,87,91,178,MM1.H3K27ac_DEGREE_TABLE.txt
42,MEF2A,72,91,163,MM1.H3K27ac_DEGREE_TABLE.txt
43,MEF2C,91,87,178,MM1.H3K27ac_DEGREE_TABLE.txt
44,MEF2D,91,84,175,MM1.H3K27ac_DEGREE_TABLE.txt
45,MYBL2,76,70,146,MM1.H3K27ac_DEGREE_TABLE.txt
46,MYC,75,73,148,MM1.H3K27ac_DEGREE_TABLE.txt
47,MZF1,65,91,156,MM1.H3K27ac_DEGREE_TABLE.txt
48,NFE2L2,83,78,161,MM1.H3K27ac_DEGREE_TABLE.txt
49,NFE2L3,86,89,175,MM1.H3K27ac_DEGREE_TABLE.txt
50,NOBOX,82,49,131,MM1.H3K27ac_DEGREE_TABLE.txt
51,NR1D1,85,91,176,MM1.H3K27ac_DEGREE_TABLE.txt
52,NR1D2,81,68,149,MM1.H3K27ac_DEGREE_TABLE.txt
53,NR3C1,87,88,175,MM1.H3K27ac_DEGREE_TABLE.txt
54,NR4A2,83,90,173,MM1.H3K27ac_DEGREE_TABLE.txt
55,POU2F2,83,93,176,MM1.H3K27ac_DEGREE_TABLE.txt
56,PRDM1,93,90,183,MM1.H3K27ac_DEGREE_TABLE.txt
57,PRDM10,70,49,119,MM1.H3K27ac_DEGREE_TABLE.txt
58,RFX1,85,90,175,MM1.H3K27ac_DEGREE_TABLE.txt
59,RFX3,81,88,169,MM1.H3K27ac_DEGREE_TABLE.txt
60,RORA,79,91,170,MM1.H3K27ac_DEGREE_TABLE.txt
61,RUNX1,92,76,168,MM1.H3K27ac_DEGREE_TABLE.txt
62,SPI1,69,93,162,MM1.H3K27ac_DEGREE_TABLE.txt
63,SREBF2,79,82,161,MM1.H3K27ac_DEGREE_TABLE.txt
64,TCF12,69,92,161,MM1.H3K27ac_DEGREE_TABLE.txt
65,TCF3,86,93,179,MM1.H3K27ac_DEGREE_TABLE.txt
66,TCF4,74,82,156,MM1.H3K27ac_DEGREE_TABLE.txt
67,THRA,85,87,172,MM1.H3K27ac_DEGREE_TABLE.txt
68,TP53,78,84,162,MM1.H3K27ac_DEGREE_TABLE.txt
69,USF1,78,82,160,MM1.H3K27ac_DEGREE_TABLE.txt
70,VSX1,75,80,155,MM1.H3K27ac_DEGREE_TABLE.txt
71,XBP1,84,59,143,MM1.H3K27ac_DEGREE_TABLE.txt
72,ZBTB1,88,54,142,MM1.H3K27ac_DEGREE_TABLE.txt
73,ZBTB38,93,73,166,MM1.H3K27ac_DEGREE_TABLE.txt
74,ZBTB7A,79,84,163,MM1.H3K27ac_DEGREE_TABLE.txt
75,ZFP91,87,75,162,MM1.H3K27ac_DEGREE_TABLE.txt
76,ZFX,86,92,178,MM1.H3K27ac_DEGREE_TABLE.txt
77,ZNF117,83,93,176,MM1.H3K27ac_DEGREE_TABLE.txt
78,ZNF143,77,88,165,MM1.H3K27ac_DEGREE_TABLE.txt
79,ZNF215,86,78,164,MM1.H3K27ac_DEGREE_TABLE.txt
80,ZNF217,89,56,145,MM1.H3K27ac_DEGREE_TABLE.txt
81,ZNF460,86,92,178,MM1.H3K27ac_DEGREE_TABLE.txt
82,ZNF483,72,89,161,MM1.H3K27ac_DEGREE_TABLE.txt
83,ZNF526,86,85,171,MM1.H3K27ac_DEGREE_TABLE.txt
84,ZNF543,86,93,179,MM1.H3K27ac_DEGREE_TABLE.txt
85,ZNF554,78,60,138,MM1.H3K27ac_DEGREE_TABLE.txt
86,ZNF555,78,91,169,MM1.H3K27ac_DEGREE_TABLE.txt
87,ZNF556,78,67,145,MM1.H3K27ac_DEGREE_TABLE.txt
88,ZNF574,83,93,176,MM1.H3K27ac_DEGREE_TABLE.txt
89,ZNF655,60,89,149,MM1.H3K27ac_DEGREE_TABLE.txt
90,ZNF710,84,77,161,MM1.H3K27ac_DEGREE_TABLE.txt
91,ZNF775,86,88,174,MM1.H3K27ac_DEGREE_TABLE.txt
92,ZNF805,86,84,170,MM1.H3K27ac_DEGREE_TABLE.txt
93,ABI3,40,9,49,MM4_jia_DEGREE_TABLE.txt
94,ARF1,23,7,30,MM4_jia_DEGREE_TABLE.txt
95,ARID5A,27,39,66,MM4_jia_DEGREE_TABLE.txt
96,ATF3,40,57,97,MM4_jia_DEGREE_TABLE.txt
97,BCL6B,50,51,101,MM4_jia_DEGREE_TABLE.txt
98,BCLAF1,39,53,92,MM4_jia_DEGREE_TABLE.txt
99,BHLHE41,36,15,51,MM4_jia_DEGREE_TABLE.txt
100,CAMTA2,44,5,49,MM4_jia_DEGREE_TABLE.txt
101,CEBPB,35,27,62,MM4_jia_DEGREE_TABLE.txt
102,CHD2,38,44,82,MM4_jia_DEGREE_TABLE.txt
103,ELF2,32,33,65,MM4_jia_DEGREE_TABLE.txt
104,ESRRA,30,51,81,MM4_jia_DEGREE_TABLE.txt
105,ETV5,33,24,57,MM4_jia_DEGREE_TABLE.txt
106,FOSB,45,20,65,MM4_jia_DEGREE_TABLE.txt
107,HBP1,42,43,85,MM4_jia_DEGREE_TABLE.txt
108,HIVEP2,45,35,80,MM4_jia_DEGREE_TABLE.txt
109,IRF2,37,38,75,MM4_jia_DEGREE_TABLE.txt
110,JUN,35,41,76,MM4_jia_DEGREE_TABLE.txt
111,JUNB,46,44,90,MM4_jia_DEGREE_TABLE.txt
112,JUND,33,54,87,MM4_jia_DEGREE_TABLE.txt
113,KLF13,28,19,47,MM4_jia_DEGREE_TABLE.txt
114,KLF2,53,37,90,MM4_jia_DEGREE_TABLE.txt
115,KLF6,46,22,68,MM4_jia_DEGREE_TABLE.txt
116,KLF7,27,53,80,MM4_jia_DEGREE_TABLE.txt
117,KLF9,40,38,78,MM4_jia_DEGREE_TABLE.txt
118,MEF2A,37,52,89,MM4_jia_DEGREE_TABLE.txt
119,MYBL2,38,30,68,MM4_jia_DEGREE_TABLE.txt
120,MYNN,35,22,57,MM4_jia_DEGREE_TABLE.txt
121,NFE2L1,44,36,80,MM4_jia_DEGREE_TABLE.txt
122,NFE2L2,32,32,64,MM4_jia_DEGREE_TABLE.txt
123,NFKB2,39,32,71,MM4_jia_DEGREE_TABLE.txt
124,NR4A2,46,41,87,MM4_jia_DEGREE_TABLE.txt
125,POU5F1,35,50,85,MM4_jia_DEGREE_TABLE.txt
126,PRDM10,28,18,46,MM4_jia_DEGREE_TABLE.txt
127,RFX1,38,49,87,MM4_jia_DEGREE_TABLE.txt
128,RFX3,41,43,84,MM4_jia_DEGREE_TABLE.txt
129,SMAD2,30,25,55,MM4_jia_DEGREE_TABLE.txt
130,SMAD4,27,36,63,MM4_jia_DEGREE_TABLE.txt
131,SP2,37,55,92,MM4_jia_DEGREE_TABLE.txt
132,SP3,33,52,85,MM4_jia_DEGREE_TABLE.txt
133,SP6,37,0,37,MM4_jia_DEGREE_TABLE.txt
134,TBP,40,57,97,MM4_jia_DEGREE_TABLE.txt
135,USF1,34,30,64,MM4_jia_DEGREE_TABLE.txt
136,VEZF1,44,27,71,MM4_jia_DEGREE_TABLE.txt
137,XBP1,38,30,68,MM4_jia_DEGREE_TABLE.txt
138,ZBTB4,46,13,59,MM4_jia_DEGREE_TABLE.txt
139,ZFP91,39,45,84,MM4_jia_DEGREE_TABLE.txt
140,ZNF16,39,50,89,MM4_jia_DEGREE_TABLE.txt
141,ZNF250,39,56,95,MM4_jia_DEGREE_TABLE.txt
142,ZNF335,33,37,70,MM4_jia_DEGREE_TABLE.txt
143,ZNF483,34,38,72,MM4_jia_DEGREE_TABLE.txt
144,ZNF580,37,44,81,MM4_jia_DEGREE_TABLE.txt
145,ZNF581,37,33,70,MM4_jia_DEGREE_TABLE.txt
146,ZNF595,28,56,84,MM4_jia_DEGREE_TABLE.txt
147,ZNF623,14,45,59,MM4_jia_DEGREE_TABLE.txt
148,ZNF718,28,51,79,MM4_jia_DEGREE_TABLE.txt
149,ZNF784,37,44,81,MM4_jia_DEGREE_TABLE.txt
150,ARF1,38,8,46,MM8_jia_DEGREE_TABLE.txt
151,ARID3A,37,37,74,MM8_jia_DEGREE_TABLE.txt
152,BCL6B,36,45,81,MM8_jia_DEGREE_TABLE.txt
153,CHD2,43,38,81,MM8_jia_DEGREE_TABLE.txt
154,DDIT3,34,29,63,MM8_jia_DEGREE_TABLE.txt
155,ELF2,28,36,64,MM8_jia_DEGREE_TABLE.txt
156,ELK4,32,35,67,MM8_jia_DEGREE_TABLE.txt
157,FOSB,34,15,49,MM8_jia_DEGREE_TABLE.txt
158,FOXO3,36,45,81,MM8_jia_DEGREE_TABLE.txt
159,HBP1,30,37,67,MM8_jia_DEGREE_TABLE.txt
160,JUNB,39,35,74,MM8_jia_DEGREE_TABLE.txt
161,JUND,38,45,83,MM8_jia_DEGREE_TABLE.txt
162,KLF13,43,26,69,MM8_jia_DEGREE_TABLE.txt
163,KLF16,26,40,66,MM8_jia_DEGREE_TABLE.txt
164,KLF2,42,41,83,MM8_jia_DEGREE_TABLE.txt
165,MEF2C,39,39,78,MM8_jia_DEGREE_TABLE.txt
166,MEF2D,43,37,80,MM8_jia_DEGREE_TABLE.txt
167,MEIS2,36,40,76,MM8_jia_DEGREE_TABLE.txt
168,MIXL1,34,33,67,MM8_jia_DEGREE_TABLE.txt
169,MYBL2,32,32,64,MM8_jia_DEGREE_TABLE.txt
170,MYC,39,27,66,MM8_jia_DEGREE_TABLE.txt
171,NHLH1,26,35,61,MM8_jia_DEGREE_TABLE.txt
172,NR3C1,31,41,72,MM8_jia_DEGREE_TABLE.txt
173,NR4A2,41,41,82,MM8_jia_DEGREE_TABLE.txt
174,NR5A2,37,37,74,MM8_jia_DEGREE_TABLE.txt
175,PAX4,34,45,79,MM8_jia_DEGREE_TABLE.txt
176,PBX4,41,25,66,MM8_jia_DEGREE_TABLE.txt
177,POU2F1,31,45,76,MM8_jia_DEGREE_TABLE.txt
178,PRDM1,41,43,84,MM8_jia_DEGREE_TABLE.txt
179,RAX2,30,25,55,MM8_jia_DEGREE_TABLE.txt
180,RFX1,37,44,81,MM8_jia_DEGREE_TABLE.txt
181,RFX3,31,39,70,MM8_jia_DEGREE_TABLE.txt
182,SIN3A,39,45,84,MM8_jia_DEGREE_TABLE.txt
183,TCF3,39,45,84,MM8_jia_DEGREE_TABLE.txt
184,USF1,34,27,61,MM8_jia_DEGREE_TABLE.txt
185,XBP1,36,28,64,MM8_jia_DEGREE_TABLE.txt
186,ZBTB38,41,26,67,MM8_jia_DEGREE_TABLE.txt
187,ZBTB7B,40,37,77,MM8_jia_DEGREE_TABLE.txt
188,ZFP91,36,34,70,MM8_jia_DEGREE_TABLE.txt
189,ZNF490,30,25,55,MM8_jia_DEGREE_TABLE.txt
190,ZNF672,27,44,71,MM8_jia_DEGREE_TABLE.txt
191,ZNF687,30,21,51,MM8_jia_DEGREE_TABLE.txt
192,ZNF692,27,38,65,MM8_jia_DEGREE_TABLE.txt
193,ZNF775,35,40,75,MM8_jia_DEGREE_TABLE.txt
194,ZNF791,30,33,63,MM8_jia_DEGREE_TABLE.txt
195,ARF1,115,56,171,KMS11_H3K27ac_DEGREE_TABLE.txt
196,ARID3B,112,107,219,KMS11_H3K27ac_DEGREE_TABLE.txt
197,ARID5A,116,116,232,KMS11_H3K27ac_DEGREE_TABLE.txt
198,ATF4,120,117,237,KMS11_H3K27ac_DEGREE_TABLE.txt
199,ATF5,119,116,235,KMS11_H3K27ac_DEGREE_TABLE.txt
200,ATF6,109,84,193,KMS11_H3K27ac_DEGREE_TABLE.txt
201,BCL6B,110,122,232,KMS11_H3K27ac_DEGREE_TABLE.txt
202,BHLHE22,114,119,233,KMS11_H3K27ac_DEGREE_TABLE.txt
203,CAMTA1,113,35,148,KMS11_H3K27ac_DEGREE_TABLE.txt
204,CAMTA2,113,24,137,KMS11_H3K27ac_DEGREE_TABLE.txt
205,CHD2,119,117,236,KMS11_H3K27ac_DEGREE_TABLE.txt
206,CREB3L4,114,95,209,KMS11_H3K27ac_DEGREE_TABLE.txt
207,CTCFL,116,122,238,KMS11_H3K27ac_DEGREE_TABLE.txt
208,CUX1,115,110,225,KMS11_H3K27ac_DEGREE_TABLE.txt
209,DBP,112,120,232,KMS11_H3K27ac_DEGREE_TABLE.txt
210,E2F1,119,112,231,KMS11_H3K27ac_DEGREE_TABLE.txt
211,E2F2,116,120,236,KMS11_H3K27ac_DEGREE_TABLE.txt
212,E2F3,109,120,229,KMS11_H3K27ac_DEGREE_TABLE.txt
213,E2F4,112,107,219,KMS11_H3K27ac_DEGREE_TABLE.txt
214,E2F6,108,121,229,KMS11_H3K27ac_DEGREE_TABLE.txt
215,ELF2,119,109,228,KMS11_H3K27ac_DEGREE_TABLE.txt
216,ETS1,115,122,237,KMS11_H3K27ac_DEGREE_TABLE.txt
217,ETV6,117,120,237,KMS11_H3K27ac_DEGREE_TABLE.txt
218,FEZF1,97,118,215,KMS11_H3K27ac_DEGREE_TABLE.txt
219,FHL1,105,62,167,KMS11_H3K27ac_DEGREE_TABLE.txt
220,FIZ1,117,122,239,KMS11_H3K27ac_DEGREE_TABLE.txt
221,FLI1,117,122,239,KMS11_H3K27ac_DEGREE_TABLE.txt
222,FOSB,112,71,183,KMS11_H3K27ac_DEGREE_TABLE.txt
223,FOXH1,112,116,228,KMS11_H3K27ac_DEGREE_TABLE.txt
224,FOXO3,120,121,241,KMS11_H3K27ac_DEGREE_TABLE.txt
225,FOXO4,110,121,231,KMS11_H3K27ac_DEGREE_TABLE.txt
226,FOXR1,116,120,236,KMS11_H3K27ac_DEGREE_TABLE.txt
227,HDAC1,112,118,230,KMS11_H3K27ac_DEGREE_TABLE.txt
228,HEY1,107,89,196,KMS11_H3K27ac_DEGREE_TABLE.txt
229,HSF4,112,107,219,KMS11_H3K27ac_DEGREE_TABLE.txt
230,ID1,113,119,232,KMS11_H3K27ac_DEGREE_TABLE.txt
231,IKZF3,121,122,243,KMS11_H3K27ac_DEGREE_TABLE.txt
232,IRF1,114,122,236,KMS11_H3K27ac_DEGREE_TABLE.txt
233,IRF2,122,115,237,KMS11_H3K27ac_DEGREE_TABLE.txt
234,IRF3,107,122,229,KMS11_H3K27ac_DEGREE_TABLE.txt
235,IRF4,115,117,232,KMS11_H3K27ac_DEGREE_TABLE.txt
236,JUNB,120,111,231,KMS11_H3K27ac_DEGREE_TABLE.txt
237,KLF1,119,122,241,KMS11_H3K27ac_DEGREE_TABLE.txt
238,KLF10,119,121,240,KMS11_H3K27ac_DEGREE_TABLE.txt
239,KLF13,120,105,225,KMS11_H3K27ac_DEGREE_TABLE.txt
240,KLF16,109,117,226,KMS11_H3K27ac_DEGREE_TABLE.txt
241,KLF3,109,119,228,KMS11_H3K27ac_DEGREE_TABLE.txt
242,KLF6,104,117,221,KMS11_H3K27ac_DEGREE_TABLE.txt
243,KLF9,117,119,236,KMS11_H3K27ac_DEGREE_TABLE.txt
244,LTF,112,108,220,KMS11_H3K27ac_DEGREE_TABLE.txt
245,MAF,107,122,229,KMS11_H3K27ac_DEGREE_TABLE.txt
246,MAFF,112,122,234,KMS11_H3K27ac_DEGREE_TABLE.txt
247,MAFG,112,120,232,KMS11_H3K27ac_DEGREE_TABLE.txt
248,MAZ,119,122,241,KMS11_H3K27ac_DEGREE_TABLE.txt
249,MEF2D,118,120,238,KMS11_H3K27ac_DEGREE_TABLE.txt
250,MLX,116,90,206,KMS11_H3K27ac_DEGREE_TABLE.txt
251,MNX1,111,108,219,KMS11_H3K27ac_DEGREE_TABLE.txt
252,MYBL2,110,94,204,KMS11_H3K27ac_DEGREE_TABLE.txt
253,MYC,121,115,236,KMS11_H3K27ac_DEGREE_TABLE.txt
254,MZF1,99,122,221,KMS11_H3K27ac_DEGREE_TABLE.txt
255,NFATC2,111,122,233,KMS11_H3K27ac_DEGREE_TABLE.txt
256,NFE2,107,101,208,KMS11_H3K27ac_DEGREE_TABLE.txt
257,NFE2L1,110,98,208,KMS11_H3K27ac_DEGREE_TABLE.txt
258,NFE2L2,107,110,217,KMS11_H3K27ac_DEGREE_TABLE.txt
259,NFE2L3,117,120,237,KMS11_H3K27ac_DEGREE_TABLE.txt
260,NFIX,119,121,240,KMS11_H3K27ac_DEGREE_TABLE.txt
261,NFKB1,113,122,235,KMS11_H3K27ac_DEGREE_TABLE.txt
262,NR1D1,91,122,213,KMS11_H3K27ac_DEGREE_TABLE.txt
263,NR3C1,121,121,242,KMS11_H3K27ac_DEGREE_TABLE.txt
264,PBX2,106,105,211,KMS11_H3K27ac_DEGREE_TABLE.txt
265,PLAGL1,118,122,240,KMS11_H3K27ac_DEGREE_TABLE.txt
266,POU2F1,100,122,222,KMS11_H3K27ac_DEGREE_TABLE.txt
267,PRDM1,119,122,241,KMS11_H3K27ac_DEGREE_TABLE.txt
268,PRDM5,119,122,241,KMS11_H3K27ac_DEGREE_TABLE.txt
269,RARA,118,122,240,KMS11_H3K27ac_DEGREE_TABLE.txt
270,RARG,115,122,237,KMS11_H3K27ac_DEGREE_TABLE.txt
271,RELB,112,111,223,KMS11_H3K27ac_DEGREE_TABLE.txt
272,RUNX2,111,121,232,KMS11_H3K27ac_DEGREE_TABLE.txt
273,RUNX3,118,122,240,KMS11_H3K27ac_DEGREE_TABLE.txt
274,RXRA,105,122,227,KMS11_H3K27ac_DEGREE_TABLE.txt
275,SMAD7,121,117,238,KMS11_H3K27ac_DEGREE_TABLE.txt
276,SNAI3,116,116,232,KMS11_H3K27ac_DEGREE_TABLE.txt
277,SOX11,107,122,229,KMS11_H3K27ac_DEGREE_TABLE.txt
278,SP1,111,122,233,KMS11_H3K27ac_DEGREE_TABLE.txt
279,SP3,95,121,216,KMS11_H3K27ac_DEGREE_TABLE.txt
280,SREBF1,120,120,240,KMS11_H3K27ac_DEGREE_TABLE.txt
281,STAT1,112,122,234,KMS11_H3K27ac_DEGREE_TABLE.txt
282,TBX6,98,117,215,KMS11_H3K27ac_DEGREE_TABLE.txt
283,TCF3,108,122,230,KMS11_H3K27ac_DEGREE_TABLE.txt
284,TCF4,107,118,225,KMS11_H3K27ac_DEGREE_TABLE.txt
285,TCFL5,116,92,208,KMS11_H3K27ac_DEGREE_TABLE.txt
286,XBP1,117,102,219,KMS11_H3K27ac_DEGREE_TABLE.txt
287,ZBTB33,115,71,186,KMS11_H3K27ac_DEGREE_TABLE.txt
288,ZBTB38,120,120,240,KMS11_H3K27ac_DEGREE_TABLE.txt
289,ZBTB7B,122,119,241,KMS11_H3K27ac_DEGREE_TABLE.txt
290,ZFP62,110,122,232,KMS11_H3K27ac_DEGREE_TABLE.txt
291,ZFP91,111,118,229,KMS11_H3K27ac_DEGREE_TABLE.txt
292,ZNF114,109,104,213,KMS11_H3K27ac_DEGREE_TABLE.txt
293,ZNF189,110,122,232,KMS11_H3K27ac_DEGREE_TABLE.txt
294,ZNF217,120,91,211,KMS11_H3K27ac_DEGREE_TABLE.txt
295,ZNF22,118,119,237,KMS11_H3K27ac_DEGREE_TABLE.txt
296,ZNF267,110,122,232,KMS11_H3K27ac_DEGREE_TABLE.txt
297,ZNF296,104,122,226,KMS11_H3K27ac_DEGREE_TABLE.txt
298,ZNF341,120,122,242,KMS11_H3K27ac_DEGREE_TABLE.txt
299,ZNF398,93,121,214,KMS11_H3K27ac_DEGREE_TABLE.txt
300,ZNF425,93,122,215,KMS11_H3K27ac_DEGREE_TABLE.txt
301,ZNF524,117,122,239,KMS11_H3K27ac_DEGREE_TABLE.txt
302,ZNF579,99,122,221,KMS11_H3K27ac_DEGREE_TABLE.txt
303,ZNF580,117,119,236,KMS11_H3K27ac_DEGREE_TABLE.txt
304,ZNF581,117,119,236,KMS11_H3K27ac_DEGREE_TABLE.txt
305,ZNF688,118,97,215,KMS11_H3K27ac_DEGREE_TABLE.txt
306,ZNF689,119,121,240,KMS11_H3K27ac_DEGREE_TABLE.txt
307,ZNF710,108,119,227,KMS11_H3K27ac_DEGREE_TABLE.txt
308,ZNF740,115,121,236,KMS11_H3K27ac_DEGREE_TABLE.txt
309,ZNF764,118,93,211,KMS11_H3K27ac_DEGREE_TABLE.txt
310,ZNF768,118,122,240,KMS11_H3K27ac_DEGREE_TABLE.txt
311,ZNF775,120,121,241,KMS11_H3K27ac_DEGREE_TABLE.txt
312,ZNF784,117,120,237,KMS11_H3K27ac_DEGREE_TABLE.txt
313,ZNF785,118,105,223,KMS11_H3K27ac_DEGREE_TABLE.txt
314,ZNF786,93,118,211,KMS11_H3K27ac_DEGREE_TABLE.txt
315,ZNF846,112,115,227,KMS11_H3K27ac_DEGREE_TABLE.txt
316,ZXDA,115,117,232,KMS11_H3K27ac_DEGREE_TABLE.txt
317,AIRE,106,85,191,MM.1S.H3K27ac_DEGREE_TABLE.txt
318,ARF1,101,34,135,MM.1S.H3K27ac_DEGREE_TABLE.txt
319,ARID3A,86,88,174,MM.1S.H3K27ac_DEGREE_TABLE.txt
320,ARID3B,103,84,187,MM.1S.H3K27ac_DEGREE_TABLE.txt
321,ARID5A,97,87,184,MM.1S.H3K27ac_DEGREE_TABLE.txt
322,ATF3,86,111,197,MM.1S.H3K27ac_DEGREE_TABLE.txt
323,ATF4,73,96,169,MM.1S.H3K27ac_DEGREE_TABLE.txt
324,ATF6,83,57,140,MM.1S.H3K27ac_DEGREE_TABLE.txt
325,BACH2,76,84,160,MM.1S.H3K27ac_DEGREE_TABLE.txt
326,BARX2,97,81,178,MM.1S.H3K27ac_DEGREE_TABLE.txt
327,BCL6B,96,110,206,MM.1S.H3K27ac_DEGREE_TABLE.txt
328,BHLHE41,98,54,152,MM.1S.H3K27ac_DEGREE_TABLE.txt
329,CAMTA2,91,19,110,MM.1S.H3K27ac_DEGREE_TABLE.txt
330,CHD2,77,100,177,MM.1S.H3K27ac_DEGREE_TABLE.txt
331,CREB3L2,84,82,166,MM.1S.H3K27ac_DEGREE_TABLE.txt
332,CTCF,105,111,216,MM.1S.H3K27ac_DEGREE_TABLE.txt
333,CTCFL,108,111,219,MM.1S.H3K27ac_DEGREE_TABLE.txt
334,DDIT3,89,86,175,MM.1S.H3K27ac_DEGREE_TABLE.txt
335,DEAF1,77,94,171,MM.1S.H3K27ac_DEGREE_TABLE.txt
336,E2F2,93,104,197,MM.1S.H3K27ac_DEGREE_TABLE.txt
337,E2F3,84,106,190,MM.1S.H3K27ac_DEGREE_TABLE.txt
338,ELF2,77,81,158,MM.1S.H3K27ac_DEGREE_TABLE.txt
339,ELK3,85,73,158,MM.1S.H3K27ac_DEGREE_TABLE.txt
340,ETS1,97,111,208,MM.1S.H3K27ac_DEGREE_TABLE.txt
341,ETV3,88,71,159,MM.1S.H3K27ac_DEGREE_TABLE.txt
342,FLI1,108,108,216,MM.1S.H3K27ac_DEGREE_TABLE.txt
343,FOSL2,89,80,169,MM.1S.H3K27ac_DEGREE_TABLE.txt
344,FOXD4L5,50,82,132,MM.1S.H3K27ac_DEGREE_TABLE.txt
345,FOXO3,110,110,220,MM.1S.H3K27ac_DEGREE_TABLE.txt
346,FOXP2,84,93,177,MM.1S.H3K27ac_DEGREE_TABLE.txt
347,GFI1,90,102,192,MM.1S.H3K27ac_DEGREE_TABLE.txt
348,HBP1,83,98,181,MM.1S.H3K27ac_DEGREE_TABLE.txt
349,HES1,108,100,208,MM.1S.H3K27ac_DEGREE_TABLE.txt
350,HES6,99,53,152,MM.1S.H3K27ac_DEGREE_TABLE.txt
351,HEY1,93,48,141,MM.1S.H3K27ac_DEGREE_TABLE.txt
352,HEY2,92,68,160,MM.1S.H3K27ac_DEGREE_TABLE.txt
353,HIVEP2,96,92,188,MM.1S.H3K27ac_DEGREE_TABLE.txt
354,IKZF3,95,108,203,MM.1S.H3K27ac_DEGREE_TABLE.txt
355,IRF1,109,107,216,MM.1S.H3K27ac_DEGREE_TABLE.txt
356,IRF2,111,87,198,MM.1S.H3K27ac_DEGREE_TABLE.txt
357,IRF4,96,98,194,MM.1S.H3K27ac_DEGREE_TABLE.txt
358,IRF5,81,92,173,MM.1S.H3K27ac_DEGREE_TABLE.txt
359,JUN,83,98,181,MM.1S.H3K27ac_DEGREE_TABLE.txt
360,JUND,69,110,179,MM.1S.H3K27ac_DEGREE_TABLE.txt
361,KLF13,109,71,180,MM.1S.H3K27ac_DEGREE_TABLE.txt
362,KLF16,66,108,174,MM.1S.H3K27ac_DEGREE_TABLE.txt
363,KLF2,92,104,196,MM.1S.H3K27ac_DEGREE_TABLE.txt
364,KLF3,92,104,196,MM.1S.H3K27ac_DEGREE_TABLE.txt
365,KLF6,94,95,189,MM.1S.H3K27ac_DEGREE_TABLE.txt
366,KLF7,78,111,189,MM.1S.H3K27ac_DEGREE_TABLE.txt
367,KLF9,82,105,187,MM.1S.H3K27ac_DEGREE_TABLE.txt
368,MAFF,84,108,192,MM.1S.H3K27ac_DEGREE_TABLE.txt
369,MAZ,76,111,187,MM.1S.H3K27ac_DEGREE_TABLE.txt
370,MEF2C,109,98,207,MM.1S.H3K27ac_DEGREE_TABLE.txt
371,MEF2D,95,91,186,MM.1S.H3K27ac_DEGREE_TABLE.txt
372,MLX,84,47,131,MM.1S.H3K27ac_DEGREE_TABLE.txt
373,MNT,84,48,132,MM.1S.H3K27ac_DEGREE_TABLE.txt
374,MXI1,97,88,185,MM.1S.H3K27ac_DEGREE_TABLE.txt
375,MYBL2,75,74,149,MM.1S.H3K27ac_DEGREE_TABLE.txt
376,MYC,108,86,194,MM.1S.H3K27ac_DEGREE_TABLE.txt
377,MYNN,74,68,142,MM.1S.H3K27ac_DEGREE_TABLE.txt
378,NFE2L2,82,83,165,MM.1S.H3K27ac_DEGREE_TABLE.txt
379,NFE2L3,105,100,205,MM.1S.H3K27ac_DEGREE_TABLE.txt
380,NFIL3,105,65,170,MM.1S.H3K27ac_DEGREE_TABLE.txt
381,NFKB1,83,111,194,MM.1S.H3K27ac_DEGREE_TABLE.txt
382,NFKB2,70,101,171,MM.1S.H3K27ac_DEGREE_TABLE.txt
383,NR3C1,79,98,177,MM.1S.H3K27ac_DEGREE_TABLE.txt
384,NRF1,69,87,156,MM.1S.H3K27ac_DEGREE_TABLE.txt
385,PKNOX1,69,97,166,MM.1S.H3K27ac_DEGREE_TABLE.txt
386,POU2F1,82,109,191,MM.1S.H3K27ac_DEGREE_TABLE.txt
387,PRDM1,108,108,216,MM.1S.H3K27ac_DEGREE_TABLE.txt
388,PRDM10,75,67,142,MM.1S.H3K27ac_DEGREE_TABLE.txt
389,PRDM15,108,109,217,MM.1S.H3K27ac_DEGREE_TABLE.txt
390,RARA,107,111,218,MM.1S.H3K27ac_DEGREE_TABLE.txt
391,RARG,100,110,210,MM.1S.H3K27ac_DEGREE_TABLE.txt
392,RUNX1,101,89,190,MM.1S.H3K27ac_DEGREE_TABLE.txt
393,RUNX2,98,103,201,MM.1S.H3K27ac_DEGREE_TABLE.txt
394,SIN3A,87,111,198,MM.1S.H3K27ac_DEGREE_TABLE.txt
395,SMAD2,82,82,164,MM.1S.H3K27ac_DEGREE_TABLE.txt
396,SMAD7,110,84,194,MM.1S.H3K27ac_DEGREE_TABLE.txt
397,SP3,70,111,181,MM.1S.H3K27ac_DEGREE_TABLE.txt
398,SREBF2,77,86,163,MM.1S.H3K27ac_DEGREE_TABLE.txt
399,TBX6,81,85,166,MM.1S.H3K27ac_DEGREE_TABLE.txt
400,TCF3,98,111,209,MM.1S.H3K27ac_DEGREE_TABLE.txt
401,TCF4,89,101,190,MM.1S.H3K27ac_DEGREE_TABLE.txt
402,TFAP4,75,79,154,MM.1S.H3K27ac_DEGREE_TABLE.txt
403,USF1,82,88,170,MM.1S.H3K27ac_DEGREE_TABLE.txt
404,VDR,95,109,204,MM.1S.H3K27ac_DEGREE_TABLE.txt
405,VSX1,76,89,165,MM.1S.H3K27ac_DEGREE_TABLE.txt
406,XBP1,108,66,174,MM.1S.H3K27ac_DEGREE_TABLE.txt
407,ZBED6,86,92,178,MM.1S.H3K27ac_DEGREE_TABLE.txt
408,ZBTB38,109,79,188,MM.1S.H3K27ac_DEGREE_TABLE.txt
409,ZBTB7B,110,93,203,MM.1S.H3K27ac_DEGREE_TABLE.txt
410,ZEB1,90,105,195,MM.1S.H3K27ac_DEGREE_TABLE.txt
411,ZFP91,103,85,188,MM.1S.H3K27ac_DEGREE_TABLE.txt
412,ZNF124,90,91,181,MM.1S.H3K27ac_DEGREE_TABLE.txt
413,ZNF189,89,111,200,MM.1S.H3K27ac_DEGREE_TABLE.txt
414,ZNF212,70,79,149,MM.1S.H3K27ac_DEGREE_TABLE.txt
415,ZNF217,100,48,148,MM.1S.H3K27ac_DEGREE_TABLE.txt
416,ZNF22,95,91,186,MM.1S.H3K27ac_DEGREE_TABLE.txt
417,ZNF334,90,86,176,MM.1S.H3K27ac_DEGREE_TABLE.txt
418,ZNF367,86,67,153,MM.1S.H3K27ac_DEGREE_TABLE.txt
419,ZNF436,74,110,184,MM.1S.H3K27ac_DEGREE_TABLE.txt
420,ZNF443,85,111,196,MM.1S.H3K27ac_DEGREE_TABLE.txt
421,ZNF490,93,81,174,MM.1S.H3K27ac_DEGREE_TABLE.txt
422,ZNF709,85,109,194,MM.1S.H3K27ac_DEGREE_TABLE.txt
423,ZNF710,106,86,192,MM.1S.H3K27ac_DEGREE_TABLE.txt
424,ZNF740,100,105,205,MM.1S.H3K27ac_DEGREE_TABLE.txt
425,ZNF775,109,104,213,MM.1S.H3K27ac_DEGREE_TABLE.txt
426,ZNF791,93,88,181,MM.1S.H3K27ac_DEGREE_TABLE.txt
427,ZXDA,103,97,200,MM.1S.H3K27ac_DEGREE_TABLE.txt
428,ARF1,112,48,160,MM7_jia_DEGREE_TABLE.txt
429,ARF4,109,69,178,MM7_jia_DEGREE_TABLE.txt
430,ARID3B,100,97,197,MM7_jia_DEGREE_TABLE.txt
431,ARID5A,103,100,203,MM7_jia_DEGREE_TABLE.txt
432,ATF4,116,117,233,MM7_jia_DEGREE_TABLE.txt
433,ATF5,93,116,209,MM7_jia_DEGREE_TABLE.txt
434,BACH1,110,104,214,MM7_jia_DEGREE_TABLE.txt
435,BCL11A,117,118,235,MM7_jia_DEGREE_TABLE.txt
436,BCL6B,105,119,224,MM7_jia_DEGREE_TABLE.txt
437,BCLAF1,96,119,215,MM7_jia_DEGREE_TABLE.txt
438,BHLHE40,109,98,207,MM7_jia_DEGREE_TABLE.txt
439,BHLHE41,118,68,186,MM7_jia_DEGREE_TABLE.txt
440,BRCA1,97,45,142,MM7_jia_DEGREE_TABLE.txt
441,CAD,114,116,230,MM7_jia_DEGREE_TABLE.txt
442,CAMTA2,113,31,144,MM7_jia_DEGREE_TABLE.txt
443,CHD2,111,114,225,MM7_jia_DEGREE_TABLE.txt
444,CREB1,99,112,211,MM7_jia_DEGREE_TABLE.txt
445,CREB3L2,114,105,219,MM7_jia_DEGREE_TABLE.txt
446,CREB3L4,112,97,209,MM7_jia_DEGREE_TABLE.txt
447,DDIT3,102,109,211,MM7_jia_DEGREE_TABLE.txt
448,DMRT2,104,84,188,MM7_jia_DEGREE_TABLE.txt
449,ELF1,103,118,221,MM7_jia_DEGREE_TABLE.txt
450,ELF2,88,103,191,MM7_jia_DEGREE_TABLE.txt
451,ERF,93,100,193,MM7_jia_DEGREE_TABLE.txt
452,ESRRA,80,118,198,MM7_jia_DEGREE_TABLE.txt
453,FLI1,117,118,235,MM7_jia_DEGREE_TABLE.txt
454,FOXO3,119,118,237,MM7_jia_DEGREE_TABLE.txt
455,GZF1,108,55,163,MM7_jia_DEGREE_TABLE.txt
456,HBP1,94,115,209,MM7_jia_DEGREE_TABLE.txt
457,HES5,102,85,187,MM7_jia_DEGREE_TABLE.txt
458,HES7,108,115,223,MM7_jia_DEGREE_TABLE.txt
459,HIVEP2,106,112,218,MM7_jia_DEGREE_TABLE.txt
460,IKZF1,112,118,230,MM7_jia_DEGREE_TABLE.txt
461,IKZF3,108,119,227,MM7_jia_DEGREE_TABLE.txt
462,IRF1,111,118,229,MM7_jia_DEGREE_TABLE.txt
463,IRF2,118,101,219,MM7_jia_DEGREE_TABLE.txt
464,IRF4,116,113,229,MM7_jia_DEGREE_TABLE.txt
465,JUNB,118,112,230,MM7_jia_DEGREE_TABLE.txt
466,KLF1,115,119,234,MM7_jia_DEGREE_TABLE.txt
467,KLF13,118,91,209,MM7_jia_DEGREE_TABLE.txt
468,KLF2,114,115,229,MM7_jia_DEGREE_TABLE.txt
469,KLF3,109,117,226,MM7_jia_DEGREE_TABLE.txt
470,KLF6,102,115,217,MM7_jia_DEGREE_TABLE.txt
471,KLF7,92,119,211,MM7_jia_DEGREE_TABLE.txt
472,KLF9,110,117,227,MM7_jia_DEGREE_TABLE.txt
473,LBX2,97,105,202,MM7_jia_DEGREE_TABLE.txt
474,MAZ,114,119,233,MM7_jia_DEGREE_TABLE.txt
475,MEF2A,103,116,219,MM7_jia_DEGREE_TABLE.txt
476,MEF2C,113,114,227,MM7_jia_DEGREE_TABLE.txt
477,MEF2D,114,110,224,MM7_jia_DEGREE_TABLE.txt
478,MEIS2,117,116,233,MM7_jia_DEGREE_TABLE.txt
479,MIXL1,110,91,201,MM7_jia_DEGREE_TABLE.txt
480,MNT,108,67,175,MM7_jia_DEGREE_TABLE.txt
481,MXD1,103,62,165,MM7_jia_DEGREE_TABLE.txt
482,MXI1,107,112,219,MM7_jia_DEGREE_TABLE.txt
483,MYBL2,92,85,177,MM7_jia_DEGREE_TABLE.txt
484,MYNN,85,88,173,MM7_jia_DEGREE_TABLE.txt
485,MZF1,112,119,231,MM7_jia_DEGREE_TABLE.txt
486,NFE2L1,102,99,201,MM7_jia_DEGREE_TABLE.txt
487,NFE2L2,113,107,220,MM7_jia_DEGREE_TABLE.txt
488,NFE2L3,107,113,220,MM7_jia_DEGREE_TABLE.txt
489,NFIX,115,113,228,MM7_jia_DEGREE_TABLE.txt
490,NFKB2,101,116,217,MM7_jia_DEGREE_TABLE.txt
491,NHLH1,97,113,210,MM7_jia_DEGREE_TABLE.txt
492,NR1D1,108,117,225,MM7_jia_DEGREE_TABLE.txt
493,NR3C1,110,115,225,MM7_jia_DEGREE_TABLE.txt
494,NR4A2,109,116,225,MM7_jia_DEGREE_TABLE.txt
495,PBX2,102,99,201,MM7_jia_DEGREE_TABLE.txt
496,POU2F1,93,118,211,MM7_jia_DEGREE_TABLE.txt
497,POU5F1,107,115,222,MM7_jia_DEGREE_TABLE.txt
498,PRDM1,115,119,234,MM7_jia_DEGREE_TABLE.txt
499,PRDM14,100,116,216,MM7_jia_DEGREE_TABLE.txt
500,RARA,103,119,222,MM7_jia_DEGREE_TABLE.txt
501,RFX1,96,119,215,MM7_jia_DEGREE_TABLE.txt
502,RFX3,107,116,223,MM7_jia_DEGREE_TABLE.txt
503,RORA,111,118,229,MM7_jia_DEGREE_TABLE.txt
504,RXRB,106,117,223,MM7_jia_DEGREE_TABLE.txt
505,SIN3A,103,119,222,MM7_jia_DEGREE_TABLE.txt
506,SMAD3,117,119,236,MM7_jia_DEGREE_TABLE.txt
507,SP3,113,119,232,MM7_jia_DEGREE_TABLE.txt
508,TBX6,97,103,200,MM7_jia_DEGREE_TABLE.txt
509,TCF12,103,119,222,MM7_jia_DEGREE_TABLE.txt
510,TCF4,108,113,221,MM7_jia_DEGREE_TABLE.txt
511,TFEB,103,78,181,MM7_jia_DEGREE_TABLE.txt
512,THRA,108,115,223,MM7_jia_DEGREE_TABLE.txt
513,USF1,99,110,209,MM7_jia_DEGREE_TABLE.txt
514,XBP1,116,93,209,MM7_jia_DEGREE_TABLE.txt
515,ZBTB20,111,88,199,MM7_jia_DEGREE_TABLE.txt
516,ZBTB3,97,119,216,MM7_jia_DEGREE_TABLE.txt
517,ZBTB32,106,93,199,MM7_jia_DEGREE_TABLE.txt
518,ZBTB34,110,91,201,MM7_jia_DEGREE_TABLE.txt
519,ZBTB38,117,102,219,MM7_jia_DEGREE_TABLE.txt
520,ZBTB5,91,119,210,MM7_jia_DEGREE_TABLE.txt
521,ZBTB7A,103,111,214,MM7_jia_DEGREE_TABLE.txt
522,ZBTB7B,118,115,233,MM7_jia_DEGREE_TABLE.txt
523,ZFP62,114,119,233,MM7_jia_DEGREE_TABLE.txt
524,ZFP91,109,112,221,MM7_jia_DEGREE_TABLE.txt
525,ZNF114,105,86,191,MM7_jia_DEGREE_TABLE.txt
526,ZNF217,113,81,194,MM7_jia_DEGREE_TABLE.txt
527,ZNF460,108,119,227,MM7_jia_DEGREE_TABLE.txt
528,ZNF483,91,117,208,MM7_jia_DEGREE_TABLE.txt
529,ZNF497,103,110,213,MM7_jia_DEGREE_TABLE.txt
530,ZNF513,90,119,209,MM7_jia_DEGREE_TABLE.txt
531,ZNF526,93,118,211,MM7_jia_DEGREE_TABLE.txt
532,ZNF543,108,118,226,MM7_jia_DEGREE_TABLE.txt
533,ZNF584,103,107,210,MM7_jia_DEGREE_TABLE.txt
534,ZNF592,99,60,159,MM7_jia_DEGREE_TABLE.txt
535,ZNF595,99,119,218,MM7_jia_DEGREE_TABLE.txt
536,ZNF619,101,109,210,MM7_jia_DEGREE_TABLE.txt
537,ZNF620,101,72,173,MM7_jia_DEGREE_TABLE.txt
538,ZNF643,113,108,221,MM7_jia_DEGREE_TABLE.txt
539,ZNF672,108,117,225,MM7_jia_DEGREE_TABLE.txt
540,ZNF687,90,70,160,MM7_jia_DEGREE_TABLE.txt
541,ZNF689,91,116,207,MM7_jia_DEGREE_TABLE.txt
542,ZNF692,108,117,225,MM7_jia_DEGREE_TABLE.txt
543,ZNF718,99,118,217,MM7_jia_DEGREE_TABLE.txt
544,ZNF79,101,109,210,MM7_jia_DEGREE_TABLE.txt
545,ZNF805,108,118,226,MM7_jia_DEGREE_TABLE.txt
546,ZNF837,103,119,222,MM7_jia_DEGREE_TABLE.txt
547,ARID3A,58,58,116,MOLP-2.H3K27ac_DEGREE_TABLE.txt
548,ATF4,63,68,131,MOLP-2.H3K27ac_DEGREE_TABLE.txt
549,BCL6B,70,71,141,MOLP-2.H3K27ac_DEGREE_TABLE.txt
550,BHLHE41,72,37,109,MOLP-2.H3K27ac_DEGREE_TABLE.txt
551,CAMTA2,68,12,80,MOLP-2.H3K27ac_DEGREE_TABLE.txt
552,CEBPB,46,55,101,MOLP-2.H3K27ac_DEGREE_TABLE.txt
553,CREB3L2,68,56,124,MOLP-2.H3K27ac_DEGREE_TABLE.txt
554,CST6,73,14,87,MOLP-2.H3K27ac_DEGREE_TABLE.txt
555,DDIT3,62,57,119,MOLP-2.H3K27ac_DEGREE_TABLE.txt
556,E2F2,64,56,120,MOLP-2.H3K27ac_DEGREE_TABLE.txt
557,ERF,57,55,112,MOLP-2.H3K27ac_DEGREE_TABLE.txt
558,FIZ1,58,71,129,MOLP-2.H3K27ac_DEGREE_TABLE.txt
559,FLI1,61,74,135,MOLP-2.H3K27ac_DEGREE_TABLE.txt
560,FOSL1,63,52,115,MOLP-2.H3K27ac_DEGREE_TABLE.txt
561,GLI1,53,64,117,MOLP-2.H3K27ac_DEGREE_TABLE.txt
562,GMEB2,46,32,78,MOLP-2.H3K27ac_DEGREE_TABLE.txt
563,HES5,58,43,101,MOLP-2.H3K27ac_DEGREE_TABLE.txt
564,IKZF3,64,75,139,MOLP-2.H3K27ac_DEGREE_TABLE.txt
565,IRF2,73,55,128,MOLP-2.H3K27ac_DEGREE_TABLE.txt
566,IRF3,67,72,139,MOLP-2.H3K27ac_DEGREE_TABLE.txt
567,IRF4,61,67,128,MOLP-2.H3K27ac_DEGREE_TABLE.txt
568,JUNB,65,63,128,MOLP-2.H3K27ac_DEGREE_TABLE.txt
569,JUND,50,75,125,MOLP-2.H3K27ac_DEGREE_TABLE.txt
570,KLF13,74,44,118,MOLP-2.H3K27ac_DEGREE_TABLE.txt
571,KLF2,75,69,144,MOLP-2.H3K27ac_DEGREE_TABLE.txt
572,MAZ,61,76,137,MOLP-2.H3K27ac_DEGREE_TABLE.txt
573,MEF2D,65,58,123,MOLP-2.H3K27ac_DEGREE_TABLE.txt
574,MEIS2,51,68,119,MOLP-2.H3K27ac_DEGREE_TABLE.txt
575,MYBL2,58,44,102,MOLP-2.H3K27ac_DEGREE_TABLE.txt
576,MZF1,47,76,123,MOLP-2.H3K27ac_DEGREE_TABLE.txt
577,NFE2L1,66,48,114,MOLP-2.H3K27ac_DEGREE_TABLE.txt
578,NFE2L2,55,54,109,MOLP-2.H3K27ac_DEGREE_TABLE.txt
579,NFE2L3,62,69,131,MOLP-2.H3K27ac_DEGREE_TABLE.txt
580,NFKB2,58,66,124,MOLP-2.H3K27ac_DEGREE_TABLE.txt
581,NFYA,56,47,103,MOLP-2.H3K27ac_DEGREE_TABLE.txt
582,NR1D1,63,68,131,MOLP-2.H3K27ac_DEGREE_TABLE.txt
583,PAX4,58,76,134,MOLP-2.H3K27ac_DEGREE_TABLE.txt
584,PAX5,56,76,132,MOLP-2.H3K27ac_DEGREE_TABLE.txt
585,PBX2,56,44,100,MOLP-2.H3K27ac_DEGREE_TABLE.txt
586,PBX4,60,54,114,MOLP-2.H3K27ac_DEGREE_TABLE.txt
587,PRDM1,72,76,148,MOLP-2.H3K27ac_DEGREE_TABLE.txt
588,PRDM10,48,38,86,MOLP-2.H3K27ac_DEGREE_TABLE.txt
589,RARA,61,76,137,MOLP-2.H3K27ac_DEGREE_TABLE.txt
590,RFX3,61,64,125,MOLP-2.H3K27ac_DEGREE_TABLE.txt
591,RXRB,68,69,137,MOLP-2.H3K27ac_DEGREE_TABLE.txt
592,SIN3A,62,76,138,MOLP-2.H3K27ac_DEGREE_TABLE.txt
593,SOX5,70,65,135,MOLP-2.H3K27ac_DEGREE_TABLE.txt
594,SP3,42,76,118,MOLP-2.H3K27ac_DEGREE_TABLE.txt
595,SREBF2,53,56,109,MOLP-2.H3K27ac_DEGREE_TABLE.txt
596,TBX2,35,67,102,MOLP-2.H3K27ac_DEGREE_TABLE.txt
597,TBX4,35,54,89,MOLP-2.H3K27ac_DEGREE_TABLE.txt
598,TBX6,58,59,117,MOLP-2.H3K27ac_DEGREE_TABLE.txt
599,TCP11,51,63,114,MOLP-2.H3K27ac_DEGREE_TABLE.txt
600,TEAD3,58,53,111,MOLP-2.H3K27ac_DEGREE_TABLE.txt
601,TEF,55,64,119,MOLP-2.H3K27ac_DEGREE_TABLE.txt
602,TFEB,67,35,102,MOLP-2.H3K27ac_DEGREE_TABLE.txt
603,THRA,63,70,133,MOLP-2.H3K27ac_DEGREE_TABLE.txt
604,VSX1,55,56,111,MOLP-2.H3K27ac_DEGREE_TABLE.txt
605,XBP1,67,51,118,MOLP-2.H3K27ac_DEGREE_TABLE.txt
606,ZBTB38,71,51,122,MOLP-2.H3K27ac_DEGREE_TABLE.txt
607,ZBTB4,55,33,88,MOLP-2.H3K27ac_DEGREE_TABLE.txt
608,ZBTB7A,50,64,114,MOLP-2.H3K27ac_DEGREE_TABLE.txt
609,ZBTB7B,73,64,137,MOLP-2.H3K27ac_DEGREE_TABLE.txt
610,ZFP91,61,58,119,MOLP-2.H3K27ac_DEGREE_TABLE.txt
611,ZNF217,66,34,100,MOLP-2.H3K27ac_DEGREE_TABLE.txt
612,ZNF283,64,75,139,MOLP-2.H3K27ac_DEGREE_TABLE.txt
613,ZNF497,48,61,109,MOLP-2.H3K27ac_DEGREE_TABLE.txt
614,ZNF524,58,74,132,MOLP-2.H3K27ac_DEGREE_TABLE.txt
615,ZNF526,57,73,130,MOLP-2.H3K27ac_DEGREE_TABLE.txt
616,ZNF580,64,71,135,MOLP-2.H3K27ac_DEGREE_TABLE.txt
617,ZNF581,64,59,123,MOLP-2.H3K27ac_DEGREE_TABLE.txt
618,ZNF584,48,46,94,MOLP-2.H3K27ac_DEGREE_TABLE.txt
619,ZNF76,53,70,123,MOLP-2.H3K27ac_DEGREE_TABLE.txt
620,ZNF775,56,62,118,MOLP-2.H3K27ac_DEGREE_TABLE.txt
621,ZNF784,64,68,132,MOLP-2.H3K27ac_DEGREE_TABLE.txt
622,ZNF837,48,72,120,MOLP-2.H3K27ac_DEGREE_TABLE.txt
623,AIRE,60,81,141,MM8.H3K27ac_DEGREE_TABLE.txt
624,ARF1,77,20,97,MM8.H3K27ac_DEGREE_TABLE.txt
625,ARF4,85,33,118,MM8.H3K27ac_DEGREE_TABLE.txt
626,BACH1,88,58,146,MM8.H3K27ac_DEGREE_TABLE.txt
627,BBX,70,86,156,MM8.H3K27ac_DEGREE_TABLE.txt
628,BCL6B,89,102,191,MM8.H3K27ac_DEGREE_TABLE.txt
629,BCLAF1,84,107,191,MM8.H3K27ac_DEGREE_TABLE.txt
630,BHLHE41,100,37,137,MM8.H3K27ac_DEGREE_TABLE.txt
631,CEBPG,70,85,155,MM8.H3K27ac_DEGREE_TABLE.txt
632,CHD2,96,91,187,MM8.H3K27ac_DEGREE_TABLE.txt
633,CREB1,79,91,170,MM8.H3K27ac_DEGREE_TABLE.txt
634,CREB3L2,94,76,170,MM8.H3K27ac_DEGREE_TABLE.txt
635,CREM,78,72,150,MM8.H3K27ac_DEGREE_TABLE.txt
636,ERF,83,73,156,MM8.H3K27ac_DEGREE_TABLE.txt
637,ESRRA,92,104,196,MM8.H3K27ac_DEGREE_TABLE.txt
638,FIZ1,68,102,170,MM8.H3K27ac_DEGREE_TABLE.txt
639,FOSB,83,49,132,MM8.H3K27ac_DEGREE_TABLE.txt
640,FOSL1,92,56,148,MM8.H3K27ac_DEGREE_TABLE.txt
641,FOXN3,84,58,142,MM8.H3K27ac_DEGREE_TABLE.txt
642,FOXO3,77,107,184,MM8.H3K27ac_DEGREE_TABLE.txt
643,GABPA,83,105,188,MM8.H3K27ac_DEGREE_TABLE.txt
644,GMEB2,67,57,124,MM8.H3K27ac_DEGREE_TABLE.txt
645,HAP1,75,7,82,MM8.H3K27ac_DEGREE_TABLE.txt
646,HBP1,82,89,171,MM8.H3K27ac_DEGREE_TABLE.txt
647,HES7,100,89,189,MM8.H3K27ac_DEGREE_TABLE.txt
648,HIVEP2,92,77,169,MM8.H3K27ac_DEGREE_TABLE.txt
649,IRF2,85,81,166,MM8.H3K27ac_DEGREE_TABLE.txt
650,IRF4,92,92,184,MM8.H3K27ac_DEGREE_TABLE.txt
651,IRF7,71,100,171,MM8.H3K27ac_DEGREE_TABLE.txt
652,JUN,81,96,177,MM8.H3K27ac_DEGREE_TABLE.txt
653,JUNB,99,88,187,MM8.H3K27ac_DEGREE_TABLE.txt
654,JUND,84,106,190,MM8.H3K27ac_DEGREE_TABLE.txt
655,KLF12,85,105,190,MM8.H3K27ac_DEGREE_TABLE.txt
656,KLF13,102,60,162,MM8.H3K27ac_DEGREE_TABLE.txt
657,KLF15,62,107,169,MM8.H3K27ac_DEGREE_TABLE.txt
658,KLF2,103,93,196,MM8.H3K27ac_DEGREE_TABLE.txt
659,KLF6,95,65,160,MM8.H3K27ac_DEGREE_TABLE.txt
660,KLF7,71,106,177,MM8.H3K27ac_DEGREE_TABLE.txt
661,KLF9,95,90,185,MM8.H3K27ac_DEGREE_TABLE.txt
662,MEF2A,77,104,181,MM8.H3K27ac_DEGREE_TABLE.txt
663,MEF2C,104,101,205,MM8.H3K27ac_DEGREE_TABLE.txt
664,MXI1,86,73,159,MM8.H3K27ac_DEGREE_TABLE.txt
665,MYC,82,63,145,MM8.H3K27ac_DEGREE_TABLE.txt
666,MYNN,79,59,138,MM8.H3K27ac_DEGREE_TABLE.txt
667,MZF1,66,106,172,MM8.H3K27ac_DEGREE_TABLE.txt
668,NFE2L2,93,62,155,MM8.H3K27ac_DEGREE_TABLE.txt
669,NFKB1,77,105,182,MM8.H3K27ac_DEGREE_TABLE.txt
670,NFKB2,74,86,160,MM8.H3K27ac_DEGREE_TABLE.txt
671,NR1D2,81,52,133,MM8.H3K27ac_DEGREE_TABLE.txt
672,NR3C1,81,87,168,MM8.H3K27ac_DEGREE_TABLE.txt
673,NR4A2,94,95,189,MM8.H3K27ac_DEGREE_TABLE.txt
674,NR4A3,90,61,151,MM8.H3K27ac_DEGREE_TABLE.txt
675,PAX4,79,107,186,MM8.H3K27ac_DEGREE_TABLE.txt
676,PAX5,82,107,189,MM8.H3K27ac_DEGREE_TABLE.txt
677,POU2F2,85,107,192,MM8.H3K27ac_DEGREE_TABLE.txt
678,PRDM1,101,104,205,MM8.H3K27ac_DEGREE_TABLE.txt
679,PRDM10,77,52,129,MM8.H3K27ac_DEGREE_TABLE.txt
680,RARA,88,107,195,MM8.H3K27ac_DEGREE_TABLE.txt
681,RAX2,68,42,110,MM8.H3K27ac_DEGREE_TABLE.txt
682,RELA,76,106,182,MM8.H3K27ac_DEGREE_TABLE.txt
683,RELB,65,67,132,MM8.H3K27ac_DEGREE_TABLE.txt
684,RFX1,74,97,171,MM8.H3K27ac_DEGREE_TABLE.txt
685,RFX3,84,89,173,MM8.H3K27ac_DEGREE_TABLE.txt
686,RFX7,84,30,114,MM8.H3K27ac_DEGREE_TABLE.txt
687,RORA,76,100,176,MM8.H3K27ac_DEGREE_TABLE.txt
688,RUNX1,84,67,151,MM8.H3K27ac_DEGREE_TABLE.txt
689,SF1,88,65,153,MM8.H3K27ac_DEGREE_TABLE.txt
690,SIN3A,91,107,198,MM8.H3K27ac_DEGREE_TABLE.txt
691,SP3,71,107,178,MM8.H3K27ac_DEGREE_TABLE.txt
692,SPI1,72,106,178,MM8.H3K27ac_DEGREE_TABLE.txt
693,SREBF2,85,72,157,MM8.H3K27ac_DEGREE_TABLE.txt
694,TBX6,92,67,159,MM8.H3K27ac_DEGREE_TABLE.txt
695,TCF12,75,95,170,MM8.H3K27ac_DEGREE_TABLE.txt
696,TCF4,77,79,156,MM8.H3K27ac_DEGREE_TABLE.txt
697,TEAD1,75,97,172,MM8.H3K27ac_DEGREE_TABLE.txt
698,TGIF2,79,71,150,MM8.H3K27ac_DEGREE_TABLE.txt
699,TP53,83,81,164,MM8.H3K27ac_DEGREE_TABLE.txt
700,XBP1,86,72,158,MM8.H3K27ac_DEGREE_TABLE.txt
701,ZBTB1,90,52,142,MM8.H3K27ac_DEGREE_TABLE.txt
702,ZBTB20,86,56,142,MM8.H3K27ac_DEGREE_TABLE.txt
703,ZBTB32,62,61,123,MM8.H3K27ac_DEGREE_TABLE.txt
704,ZBTB38,107,68,175,MM8.H3K27ac_DEGREE_TABLE.txt
705,ZBTB5,81,96,177,MM8.H3K27ac_DEGREE_TABLE.txt
706,ZFP62,89,105,194,MM8.H3K27ac_DEGREE_TABLE.txt
707,ZFP91,87,74,161,MM8.H3K27ac_DEGREE_TABLE.txt
708,ZFX,73,107,180,MM8.H3K27ac_DEGREE_TABLE.txt
709,ZNF143,79,82,161,MM8.H3K27ac_DEGREE_TABLE.txt
710,ZNF16,76,93,169,MM8.H3K27ac_DEGREE_TABLE.txt
711,ZNF250,76,107,183,MM8.H3K27ac_DEGREE_TABLE.txt
712,ZNF460,82,107,189,MM8.H3K27ac_DEGREE_TABLE.txt
713,ZNF48,76,90,166,MM8.H3K27ac_DEGREE_TABLE.txt
714,ZNF483,72,93,165,MM8.H3K27ac_DEGREE_TABLE.txt
715,ZNF490,85,58,143,MM8.H3K27ac_DEGREE_TABLE.txt
716,ZNF524,68,100,168,MM8.H3K27ac_DEGREE_TABLE.txt
717,ZNF526,83,99,182,MM8.H3K27ac_DEGREE_TABLE.txt
718,ZNF543,82,98,180,MM8.H3K27ac_DEGREE_TABLE.txt
719,ZNF574,99,103,202,MM8.H3K27ac_DEGREE_TABLE.txt
720,ZNF580,92,99,191,MM8.H3K27ac_DEGREE_TABLE.txt
721,ZNF581,92,79,171,MM8.H3K27ac_DEGREE_TABLE.txt
722,ZNF592,77,31,108,MM8.H3K27ac_DEGREE_TABLE.txt
723,ZNF655,62,97,159,MM8.H3K27ac_DEGREE_TABLE.txt
724,ZNF689,77,84,161,MM8.H3K27ac_DEGREE_TABLE.txt
725,ZNF771,76,65,141,MM8.H3K27ac_DEGREE_TABLE.txt
726,ZNF775,80,96,176,MM8.H3K27ac_DEGREE_TABLE.txt
727,ZNF784,92,97,189,MM8.H3K27ac_DEGREE_TABLE.txt
728,ZNF791,85,68,153,MM8.H3K27ac_DEGREE_TABLE.txt
729,ZNF805,82,101,183,MM8.H3K27ac_DEGREE_TABLE.txt
730,ARF1,110,45,155,MM9_jia_DEGREE_TABLE.txt
731,ARF4,110,76,186,MM9_jia_DEGREE_TABLE.txt
732,ARID3A,116,106,222,MM9_jia_DEGREE_TABLE.txt
733,ARID3B,107,101,208,MM9_jia_DEGREE_TABLE.txt
734,ATF4,116,121,237,MM9_jia_DEGREE_TABLE.txt
735,BACH1,110,109,219,MM9_jia_DEGREE_TABLE.txt
736,BCL11A,122,124,246,MM9_jia_DEGREE_TABLE.txt
737,BCL6B,99,126,225,MM9_jia_DEGREE_TABLE.txt
738,BCLAF1,97,126,223,MM9_jia_DEGREE_TABLE.txt
739,BHLHE41,125,86,211,MM9_jia_DEGREE_TABLE.txt
740,BRCA1,102,39,141,MM9_jia_DEGREE_TABLE.txt
741,CAMTA2,110,39,149,MM9_jia_DEGREE_TABLE.txt
742,CEBPB,100,114,214,MM9_jia_DEGREE_TABLE.txt
743,CEBPG,92,114,206,MM9_jia_DEGREE_TABLE.txt
744,CHD2,114,124,238,MM9_jia_DEGREE_TABLE.txt
745,CREB1,111,123,234,MM9_jia_DEGREE_TABLE.txt
746,CREB3L2,123,114,237,MM9_jia_DEGREE_TABLE.txt
747,CTCF,101,126,227,MM9_jia_DEGREE_TABLE.txt
748,CTCFL,116,126,242,MM9_jia_DEGREE_TABLE.txt
749,CUX1,124,108,232,MM9_jia_DEGREE_TABLE.txt
750,DDIT3,108,119,227,MM9_jia_DEGREE_TABLE.txt
751,ELF1,111,126,237,MM9_jia_DEGREE_TABLE.txt
752,ELF2,99,116,215,MM9_jia_DEGREE_TABLE.txt
753,ELK4,105,120,225,MM9_jia_DEGREE_TABLE.txt
754,ERF,106,111,217,MM9_jia_DEGREE_TABLE.txt
755,ESR1,125,125,250,MM9_jia_DEGREE_TABLE.txt
756,ESRRA,111,125,236,MM9_jia_DEGREE_TABLE.txt
757,ESRRG,111,123,234,MM9_jia_DEGREE_TABLE.txt
758,ETS1,111,126,237,MM9_jia_DEGREE_TABLE.txt
759,ETV6,120,124,244,MM9_jia_DEGREE_TABLE.txt
760,FLI1,123,126,249,MM9_jia_DEGREE_TABLE.txt
761,FOSB,93,65,158,MM9_jia_DEGREE_TABLE.txt
762,FOXD4L5,110,105,215,MM9_jia_DEGREE_TABLE.txt
763,FOXN3,122,49,171,MM9_jia_DEGREE_TABLE.txt
764,FOXO3,115,126,241,MM9_jia_DEGREE_TABLE.txt
765,FOXP2,114,115,229,MM9_jia_DEGREE_TABLE.txt
766,FOXR1,105,122,227,MM9_jia_DEGREE_TABLE.txt
767,GZF1,110,52,162,MM9_jia_DEGREE_TABLE.txt
768,HAP1,93,27,120,MM9_jia_DEGREE_TABLE.txt
769,HBP1,108,120,228,MM9_jia_DEGREE_TABLE.txt
770,HES7,114,125,239,MM9_jia_DEGREE_TABLE.txt
771,HEY1,113,88,201,MM9_jia_DEGREE_TABLE.txt
772,HEY2,122,96,218,MM9_jia_DEGREE_TABLE.txt
773,HIVEP2,123,120,243,MM9_jia_DEGREE_TABLE.txt
774,IKZF1,123,123,246,MM9_jia_DEGREE_TABLE.txt
775,IKZF3,113,126,239,MM9_jia_DEGREE_TABLE.txt
776,IRF1,123,126,249,MM9_jia_DEGREE_TABLE.txt
777,IRF2,126,98,224,MM9_jia_DEGREE_TABLE.txt
778,IRF3,112,124,236,MM9_jia_DEGREE_TABLE.txt
779,IRF4,125,121,246,MM9_jia_DEGREE_TABLE.txt
780,JUN,99,123,222,MM9_jia_DEGREE_TABLE.txt
781,JUNB,112,120,232,MM9_jia_DEGREE_TABLE.txt
782,JUND,95,126,221,MM9_jia_DEGREE_TABLE.txt
783,KLF10,113,126,239,MM9_jia_DEGREE_TABLE.txt
784,KLF13,125,108,233,MM9_jia_DEGREE_TABLE.txt
785,KLF16,106,126,232,MM9_jia_DEGREE_TABLE.txt
786,KLF2,122,126,248,MM9_jia_DEGREE_TABLE.txt
787,KLF3,111,124,235,MM9_jia_DEGREE_TABLE.txt
788,KLF6,110,124,234,MM9_jia_DEGREE_TABLE.txt
789,KLF7,96,126,222,MM9_jia_DEGREE_TABLE.txt
790,MAF,112,126,238,MM9_jia_DEGREE_TABLE.txt
791,MEF2B,117,122,239,MM9_jia_DEGREE_TABLE.txt
792,MEF2C,122,120,242,MM9_jia_DEGREE_TABLE.txt
793,MEF2D,117,116,233,MM9_jia_DEGREE_TABLE.txt
794,MNT,112,85,197,MM9_jia_DEGREE_TABLE.txt
795,MXD1,110,76,186,MM9_jia_DEGREE_TABLE.txt
796,MYBL2,117,92,209,MM9_jia_DEGREE_TABLE.txt
797,MZF1,112,125,237,MM9_jia_DEGREE_TABLE.txt
798,NFE2,98,97,195,MM9_jia_DEGREE_TABLE.txt
799,NFE2L1,106,106,212,MM9_jia_DEGREE_TABLE.txt
800,NFE2L2,115,112,227,MM9_jia_DEGREE_TABLE.txt
801,NFE2L3,113,124,237,MM9_jia_DEGREE_TABLE.txt
802,NFKB1,107,126,233,MM9_jia_DEGREE_TABLE.txt
803,NFKB2,107,123,230,MM9_jia_DEGREE_TABLE.txt
804,NR1D1,109,125,234,MM9_jia_DEGREE_TABLE.txt
805,NR1D2,113,105,218,MM9_jia_DEGREE_TABLE.txt
806,NR3C1,117,121,238,MM9_jia_DEGREE_TABLE.txt
807,NR4A2,113,124,237,MM9_jia_DEGREE_TABLE.txt
808,PAX5,122,126,248,MM9_jia_DEGREE_TABLE.txt
809,PBX2,108,94,202,MM9_jia_DEGREE_TABLE.txt
810,POU2F2,114,126,240,MM9_jia_DEGREE_TABLE.txt
811,POU5F1,113,123,236,MM9_jia_DEGREE_TABLE.txt
812,PPARD,107,115,222,MM9_jia_DEGREE_TABLE.txt
813,PRDM1,126,126,252,MM9_jia_DEGREE_TABLE.txt
814,PRDM10,98,88,186,MM9_jia_DEGREE_TABLE.txt
815,PRDM14,115,121,236,MM9_jia_DEGREE_TABLE.txt
816,PRDM5,123,126,249,MM9_jia_DEGREE_TABLE.txt
817,RARA,119,126,245,MM9_jia_DEGREE_TABLE.txt
818,REL,110,122,232,MM9_jia_DEGREE_TABLE.txt
819,RELA,98,126,224,MM9_jia_DEGREE_TABLE.txt
820,RERE,124,102,226,MM9_jia_DEGREE_TABLE.txt
821,RFX1,113,126,239,MM9_jia_DEGREE_TABLE.txt
822,RFX3,106,124,230,MM9_jia_DEGREE_TABLE.txt
823,RREB1,119,126,245,MM9_jia_DEGREE_TABLE.txt
824,RUNX1,124,107,231,MM9_jia_DEGREE_TABLE.txt
825,RXRB,113,123,236,MM9_jia_DEGREE_TABLE.txt
826,SF1,100,104,204,MM9_jia_DEGREE_TABLE.txt
827,SIN3A,108,126,234,MM9_jia_DEGREE_TABLE.txt
828,SMAD3,122,126,248,MM9_jia_DEGREE_TABLE.txt
829,SMAD7,126,105,231,MM9_jia_DEGREE_TABLE.txt
830,SP100,112,68,180,MM9_jia_DEGREE_TABLE.txt
831,SP3,102,126,228,MM9_jia_DEGREE_TABLE.txt
832,SREBF2,104,118,222,MM9_jia_DEGREE_TABLE.txt
833,TCF12,112,125,237,MM9_jia_DEGREE_TABLE.txt
834,TCF3,105,126,231,MM9_jia_DEGREE_TABLE.txt
835,TFEB,122,87,209,MM9_jia_DEGREE_TABLE.txt
836,TGIF2,111,112,223,MM9_jia_DEGREE_TABLE.txt
837,THRA,109,125,234,MM9_jia_DEGREE_TABLE.txt
838,XBP1,124,102,226,MM9_jia_DEGREE_TABLE.txt
839,ZBTB1,120,103,223,MM9_jia_DEGREE_TABLE.txt
840,ZBTB20,120,103,223,MM9_jia_DEGREE_TABLE.txt
841,ZBTB32,109,98,207,MM9_jia_DEGREE_TABLE.txt
842,ZBTB38,124,114,238,MM9_jia_DEGREE_TABLE.txt
843,ZBTB7A,113,123,236,MM9_jia_DEGREE_TABLE.txt
844,ZBTB7B,119,124,243,MM9_jia_DEGREE_TABLE.txt
845,ZFP62,117,126,243,MM9_jia_DEGREE_TABLE.txt
846,ZFP91,113,121,234,MM9_jia_DEGREE_TABLE.txt
847,ZNF143,96,125,221,MM9_jia_DEGREE_TABLE.txt
848,ZNF217,124,85,209,MM9_jia_DEGREE_TABLE.txt
849,ZNF283,113,126,239,MM9_jia_DEGREE_TABLE.txt
850,ZNF526,106,125,231,MM9_jia_DEGREE_TABLE.txt
851,ZNF574,114,125,239,MM9_jia_DEGREE_TABLE.txt
852,ZNF689,93,121,214,MM9_jia_DEGREE_TABLE.txt
853,ZNF76,107,126,233,MM9_jia_DEGREE_TABLE.txt
854,ZNF775,115,123,238,MM9_jia_DEGREE_TABLE.txt
855,ZNF860,123,125,248,MM9_jia_DEGREE_TABLE.txt
856,ARF1,56,24,80,MM5_jia_DEGREE_TABLE.txt
857,ARID3B,73,66,139,MM5_jia_DEGREE_TABLE.txt
858,BACH1,77,55,132,MM5_jia_DEGREE_TABLE.txt
859,BHLHE41,85,31,116,MM5_jia_DEGREE_TABLE.txt
860,CHD2,85,84,169,MM5_jia_DEGREE_TABLE.txt
861,CREB1,61,73,134,MM5_jia_DEGREE_TABLE.txt
862,ESRRA,75,87,162,MM5_jia_DEGREE_TABLE.txt
863,FLI1,81,88,169,MM5_jia_DEGREE_TABLE.txt
864,FOSB,64,36,100,MM5_jia_DEGREE_TABLE.txt
865,FOSL1,87,49,136,MM5_jia_DEGREE_TABLE.txt
866,FOXN3,68,46,114,MM5_jia_DEGREE_TABLE.txt
867,FOXO3,73,89,162,MM5_jia_DEGREE_TABLE.txt
868,FOXP2,73,74,147,MM5_jia_DEGREE_TABLE.txt
869,GABPA,67,89,156,MM5_jia_DEGREE_TABLE.txt
870,GFI1,73,79,152,MM5_jia_DEGREE_TABLE.txt
871,HBP1,71,78,149,MM5_jia_DEGREE_TABLE.txt
872,HES1,80,74,154,MM5_jia_DEGREE_TABLE.txt
873,HIVEP2,77,70,147,MM5_jia_DEGREE_TABLE.txt
874,IRF1,85,88,173,MM5_jia_DEGREE_TABLE.txt
875,IRF5,70,78,148,MM5_jia_DEGREE_TABLE.txt
876,JUNB,83,73,156,MM5_jia_DEGREE_TABLE.txt
877,JUND,70,90,160,MM5_jia_DEGREE_TABLE.txt
878,KLF10,69,89,158,MM5_jia_DEGREE_TABLE.txt
879,KLF12,75,90,165,MM5_jia_DEGREE_TABLE.txt
880,KLF13,88,53,141,MM5_jia_DEGREE_TABLE.txt
881,KLF15,67,90,157,MM5_jia_DEGREE_TABLE.txt
882,KLF16,54,86,140,MM5_jia_DEGREE_TABLE.txt
883,KLF2,87,84,171,MM5_jia_DEGREE_TABLE.txt
884,KLF6,75,63,138,MM5_jia_DEGREE_TABLE.txt
885,KLF9,79,85,164,MM5_jia_DEGREE_TABLE.txt
886,LHX6,65,68,133,MM5_jia_DEGREE_TABLE.txt
887,MAZ,68,90,158,MM5_jia_DEGREE_TABLE.txt
888,MEF2A,64,88,152,MM5_jia_DEGREE_TABLE.txt
889,MEF2C,88,83,171,MM5_jia_DEGREE_TABLE.txt
890,MNT,65,31,96,MM5_jia_DEGREE_TABLE.txt
891,MYBL2,62,54,116,MM5_jia_DEGREE_TABLE.txt
892,MYC,71,60,131,MM5_jia_DEGREE_TABLE.txt
893,MYNN,66,50,116,MM5_jia_DEGREE_TABLE.txt
894,NFE2L2,77,60,137,MM5_jia_DEGREE_TABLE.txt
895,NFE2L3,79,79,158,MM5_jia_DEGREE_TABLE.txt
896,NFKB1,57,90,147,MM5_jia_DEGREE_TABLE.txt
897,NFKB2,63,76,139,MM5_jia_DEGREE_TABLE.txt
898,NFYA,72,69,141,MM5_jia_DEGREE_TABLE.txt
899,NR1D1,83,80,163,MM5_jia_DEGREE_TABLE.txt
900,NR3C1,75,71,146,MM5_jia_DEGREE_TABLE.txt
901,NR4A2,78,85,163,MM5_jia_DEGREE_TABLE.txt
902,NR4A3,74,56,130,MM5_jia_DEGREE_TABLE.txt
903,PAX4,70,90,160,MM5_jia_DEGREE_TABLE.txt
904,PBX4,71,57,128,MM5_jia_DEGREE_TABLE.txt
905,PPARA,64,40,104,MM5_jia_DEGREE_TABLE.txt
906,PRDM1,90,90,180,MM5_jia_DEGREE_TABLE.txt
907,PRDM10,65,44,109,MM5_jia_DEGREE_TABLE.txt
908,RARA,73,89,162,MM5_jia_DEGREE_TABLE.txt
909,RELA,68,90,158,MM5_jia_DEGREE_TABLE.txt
910,RFX1,58,87,145,MM5_jia_DEGREE_TABLE.txt
911,RFX3,75,74,149,MM5_jia_DEGREE_TABLE.txt
912,RORA,66,84,150,MM5_jia_DEGREE_TABLE.txt
913,RUNX1,78,61,139,MM5_jia_DEGREE_TABLE.txt
914,SF1,73,55,128,MM5_jia_DEGREE_TABLE.txt
915,SIN3A,79,90,169,MM5_jia_DEGREE_TABLE.txt
916,SP3,56,90,146,MM5_jia_DEGREE_TABLE.txt
917,SP4,58,90,148,MM5_jia_DEGREE_TABLE.txt
918,TBX6,70,55,125,MM5_jia_DEGREE_TABLE.txt
919,TCF12,66,87,153,MM5_jia_DEGREE_TABLE.txt
920,TCF3,80,90,170,MM5_jia_DEGREE_TABLE.txt
921,TGIF2,70,58,128,MM5_jia_DEGREE_TABLE.txt
922,THRA,83,74,157,MM5_jia_DEGREE_TABLE.txt
923,XBP1,77,63,140,MM5_jia_DEGREE_TABLE.txt
924,YY1,68,90,158,MM5_jia_DEGREE_TABLE.txt
925,ZBTB1,66,54,120,MM5_jia_DEGREE_TABLE.txt
926,ZBTB20,83,56,139,MM5_jia_DEGREE_TABLE.txt
927,ZBTB3,68,79,147,MM5_jia_DEGREE_TABLE.txt
928,ZBTB38,90,62,152,MM5_jia_DEGREE_TABLE.txt
929,ZBTB5,68,82,150,MM5_jia_DEGREE_TABLE.txt
930,ZBTB7A,63,78,141,MM5_jia_DEGREE_TABLE.txt
931,ZBTB7B,65,74,139,MM5_jia_DEGREE_TABLE.txt
932,ZEB1,77,74,151,MM5_jia_DEGREE_TABLE.txt
933,ZFP62,80,87,167,MM5_jia_DEGREE_TABLE.txt
934,ZFP91,84,71,155,MM5_jia_DEGREE_TABLE.txt
935,ZNF131,55,68,123,MM5_jia_DEGREE_TABLE.txt
936,ZNF143,64,76,140,MM5_jia_DEGREE_TABLE.txt
937,ZNF367,75,47,122,MM5_jia_DEGREE_TABLE.txt
938,ZNF48,59,79,138,MM5_jia_DEGREE_TABLE.txt
939,ZNF483,55,79,134,MM5_jia_DEGREE_TABLE.txt
940,ZNF490,59,56,115,MM5_jia_DEGREE_TABLE.txt
941,ZNF592,78,30,108,MM5_jia_DEGREE_TABLE.txt
942,ZNF689,63,79,142,MM5_jia_DEGREE_TABLE.txt
943,ZNF771,59,58,117,MM5_jia_DEGREE_TABLE.txt
944,ZNF775,68,79,147,MM5_jia_DEGREE_TABLE.txt
945,ZNF791,59,64,123,MM5_jia_DEGREE_TABLE.txt
946,ARF1,115,43,158,MM1_jia_DEGREE_TABLE.txt
947,ARF4,113,60,173,MM1_jia_DEGREE_TABLE.txt
948,ARID3A,119,110,229,MM1_jia_DEGREE_TABLE.txt
949,ATF4,117,117,234,MM1_jia_DEGREE_TABLE.txt
950,BCL11A,112,119,231,MM1_jia_DEGREE_TABLE.txt
951,BCL6B,97,121,218,MM1_jia_DEGREE_TABLE.txt
952,BCLAF1,91,120,211,MM1_jia_DEGREE_TABLE.txt
953,BHLHE40,109,97,206,MM1_jia_DEGREE_TABLE.txt
954,BHLHE41,118,70,188,MM1_jia_DEGREE_TABLE.txt
955,CAMTA2,108,32,140,MM1_jia_DEGREE_TABLE.txt
956,CHD2,120,118,238,MM1_jia_DEGREE_TABLE.txt
957,CREB3L2,117,106,223,MM1_jia_DEGREE_TABLE.txt
958,CREB3L4,112,89,201,MM1_jia_DEGREE_TABLE.txt
959,DDIT3,97,114,211,MM1_jia_DEGREE_TABLE.txt
960,DMRT2,106,97,203,MM1_jia_DEGREE_TABLE.txt
961,E2F3,112,120,232,MM1_jia_DEGREE_TABLE.txt
962,ELK4,95,114,209,MM1_jia_DEGREE_TABLE.txt
963,ESRRA,105,120,225,MM1_jia_DEGREE_TABLE.txt
964,ESRRG,96,118,214,MM1_jia_DEGREE_TABLE.txt
965,ETV6,106,118,224,MM1_jia_DEGREE_TABLE.txt
966,FBP1,98,115,213,MM1_jia_DEGREE_TABLE.txt
967,FBP2,98,117,215,MM1_jia_DEGREE_TABLE.txt
968,FLI1,120,121,241,MM1_jia_DEGREE_TABLE.txt
969,FOSL1,99,90,189,MM1_jia_DEGREE_TABLE.txt
970,FOXO3,117,121,238,MM1_jia_DEGREE_TABLE.txt
971,FOXP2,97,113,210,MM1_jia_DEGREE_TABLE.txt
972,GABPA,101,121,222,MM1_jia_DEGREE_TABLE.txt
973,GZF1,105,53,158,MM1_jia_DEGREE_TABLE.txt
974,HAP1,98,20,118,MM1_jia_DEGREE_TABLE.txt
975,HBP1,95,117,212,MM1_jia_DEGREE_TABLE.txt
976,HES7,112,120,232,MM1_jia_DEGREE_TABLE.txt
977,HEY2,102,88,190,MM1_jia_DEGREE_TABLE.txt
978,HINFP,103,114,217,MM1_jia_DEGREE_TABLE.txt
979,HIVEP2,110,113,223,MM1_jia_DEGREE_TABLE.txt
980,IKZF1,115,117,232,MM1_jia_DEGREE_TABLE.txt
981,IKZF3,110,121,231,MM1_jia_DEGREE_TABLE.txt
982,IRF1,106,121,227,MM1_jia_DEGREE_TABLE.txt
983,IRF2,118,98,216,MM1_jia_DEGREE_TABLE.txt
984,IRF4,121,115,236,MM1_jia_DEGREE_TABLE.txt
985,IRF7,91,120,211,MM1_jia_DEGREE_TABLE.txt
986,IRF9,105,116,221,MM1_jia_DEGREE_TABLE.txt
987,JUNB,107,111,218,MM1_jia_DEGREE_TABLE.txt
988,JUND,97,120,217,MM1_jia_DEGREE_TABLE.txt
989,KLF1,114,121,235,MM1_jia_DEGREE_TABLE.txt
990,KLF13,118,98,216,MM1_jia_DEGREE_TABLE.txt
991,KLF2,116,119,235,MM1_jia_DEGREE_TABLE.txt
992,KLF3,112,119,231,MM1_jia_DEGREE_TABLE.txt
993,KLF6,100,113,213,MM1_jia_DEGREE_TABLE.txt
994,KLF9,111,120,231,MM1_jia_DEGREE_TABLE.txt
995,LHX6,104,107,211,MM1_jia_DEGREE_TABLE.txt
996,MEF2A,104,121,225,MM1_jia_DEGREE_TABLE.txt
997,MEF2B,82,117,199,MM1_jia_DEGREE_TABLE.txt
998,MEF2C,117,121,238,MM1_jia_DEGREE_TABLE.txt
999,MEF2D,117,113,230,MM1_jia_DEGREE_TABLE.txt
1000,MEIS2,108,120,228,MM1_jia_DEGREE_TABLE.txt
1001,MIXL1,107,94,201,MM1_jia_DEGREE_TABLE.txt
1002,MNT,112,67,179,MM1_jia_DEGREE_TABLE.txt
1003,MXI1,99,114,213,MM1_jia_DEGREE_TABLE.txt
1004,MYNN,95,88,183,MM1_jia_DEGREE_TABLE.txt
1005,MZF1,97,120,217,MM1_jia_DEGREE_TABLE.txt
1006,NFE2L2,99,102,201,MM1_jia_DEGREE_TABLE.txt
1007,NFIX,114,110,224,MM1_jia_DEGREE_TABLE.txt
1008,NFKB2,90,114,204,MM1_jia_DEGREE_TABLE.txt
1009,NFYA,97,97,194,MM1_jia_DEGREE_TABLE.txt
1010,NHLH1,106,111,217,MM1_jia_DEGREE_TABLE.txt
1011,NR1D2,107,101,208,MM1_jia_DEGREE_TABLE.txt
1012,NR3C1,114,115,229,MM1_jia_DEGREE_TABLE.txt
1013,NR4A2,108,119,227,MM1_jia_DEGREE_TABLE.txt
1014,NR4A3,92,87,179,MM1_jia_DEGREE_TABLE.txt
1015,PBX2,109,99,208,MM1_jia_DEGREE_TABLE.txt
1016,PBX4,109,100,209,MM1_jia_DEGREE_TABLE.txt
1017,POU2F1,106,121,227,MM1_jia_DEGREE_TABLE.txt
1018,POU2F2,114,121,235,MM1_jia_DEGREE_TABLE.txt
1019,POU5F1,103,117,220,MM1_jia_DEGREE_TABLE.txt
1020,PPARD,103,102,205,MM1_jia_DEGREE_TABLE.txt
1021,PRDM1,119,119,238,MM1_jia_DEGREE_TABLE.txt
1022,PRDM10,85,79,164,MM1_jia_DEGREE_TABLE.txt
1023,RAX2,88,69,157,MM1_jia_DEGREE_TABLE.txt
1024,RELA,103,121,224,MM1_jia_DEGREE_TABLE.txt
1025,RFX1,101,120,221,MM1_jia_DEGREE_TABLE.txt
1026,RFX3,106,119,225,MM1_jia_DEGREE_TABLE.txt
1027,RREB1,108,121,229,MM1_jia_DEGREE_TABLE.txt
1028,RUNX1,112,114,226,MM1_jia_DEGREE_TABLE.txt
1029,RXRB,107,116,223,MM1_jia_DEGREE_TABLE.txt
1030,SF1,104,98,202,MM1_jia_DEGREE_TABLE.txt
1031,SIN3A,106,121,227,MM1_jia_DEGREE_TABLE.txt
1032,SMAD3,117,121,238,MM1_jia_DEGREE_TABLE.txt
1033,SNAPC4,106,92,198,MM1_jia_DEGREE_TABLE.txt
1034,SP3,98,121,219,MM1_jia_DEGREE_TABLE.txt
1035,TCF3,114,121,235,MM1_jia_DEGREE_TABLE.txt
1036,TCF4,112,113,225,MM1_jia_DEGREE_TABLE.txt
1037,USF1,107,112,219,MM1_jia_DEGREE_TABLE.txt
1038,XBP1,117,88,205,MM1_jia_DEGREE_TABLE.txt
1039,ZBED6,114,100,214,MM1_jia_DEGREE_TABLE.txt
1040,ZBTB1,110,91,201,MM1_jia_DEGREE_TABLE.txt
1041,ZBTB20,116,87,203,MM1_jia_DEGREE_TABLE.txt
1042,ZBTB3,102,121,223,MM1_jia_DEGREE_TABLE.txt
1043,ZBTB32,102,90,192,MM1_jia_DEGREE_TABLE.txt
1044,ZBTB38,120,102,222,MM1_jia_DEGREE_TABLE.txt
1045,ZBTB7A,107,113,220,MM1_jia_DEGREE_TABLE.txt
1046,ZBTB7B,121,117,238,MM1_jia_DEGREE_TABLE.txt
1047,ZFP62,109,121,230,MM1_jia_DEGREE_TABLE.txt
1048,ZFP91,109,113,222,MM1_jia_DEGREE_TABLE.txt
1049,ZNF114,106,81,187,MM1_jia_DEGREE_TABLE.txt
1050,ZNF143,89,117,206,MM1_jia_DEGREE_TABLE.txt
1051,ZNF217,111,76,187,MM1_jia_DEGREE_TABLE.txt
1052,ZNF367,103,101,204,MM1_jia_DEGREE_TABLE.txt
1053,ZNF460,110,121,231,MM1_jia_DEGREE_TABLE.txt
1054,ZNF490,104,96,200,MM1_jia_DEGREE_TABLE.txt
1055,ZNF519,106,120,226,MM1_jia_DEGREE_TABLE.txt
1056,ZNF543,110,120,230,MM1_jia_DEGREE_TABLE.txt
1057,ZNF554,95,92,187,MM1_jia_DEGREE_TABLE.txt
1058,ZNF574,114,121,235,MM1_jia_DEGREE_TABLE.txt
1059,ZNF592,110,63,173,MM1_jia_DEGREE_TABLE.txt
1060,ZNF672,103,120,223,MM1_jia_DEGREE_TABLE.txt
1061,ZNF681,115,121,236,MM1_jia_DEGREE_TABLE.txt
1062,ZNF692,103,119,222,MM1_jia_DEGREE_TABLE.txt
1063,ZNF76,103,117,220,MM1_jia_DEGREE_TABLE.txt
1064,ZNF775,108,115,223,MM1_jia_DEGREE_TABLE.txt
1065,ZNF791,104,106,210,MM1_jia_DEGREE_TABLE.txt
1066,ZNF805,110,119,229,MM1_jia_DEGREE_TABLE.txt
1067,AIRE,39,35,74,RPMI8226.H3K27ac_DEGREE_TABLE.txt
1068,ARF1,22,9,31,RPMI8226.H3K27ac_DEGREE_TABLE.txt
1069,ARID3A,31,42,73,RPMI8226.H3K27ac_DEGREE_TABLE.txt
1070,ARID5A,42,37,79,RPMI8226.H3K27ac_DEGREE_TABLE.txt
1071,ATF3,33,46,79,RPMI8226.H3K27ac_DEGREE_TABLE.txt
1072,BCL11A,33,44,77,RPMI8226.H3K27ac_DEGREE_TABLE.txt
1073,CAD,43,39,82,RPMI8226.H3K27ac_DEGREE_TABLE.txt
1074,CAMTA1,42,11,53,RPMI8226.H3K27ac_DEGREE_TABLE.txt
1075,CEBPB,37,30,67,RPMI8226.H3K27ac_DEGREE_TABLE.txt
1076,CTCF,42,46,88,RPMI8226.H3K27ac_DEGREE_TABLE.txt
1077,DDIT3,38,28,66,RPMI8226.H3K27ac_DEGREE_TABLE.txt
1078,E2F3,36,41,77,RPMI8226.H3K27ac_DEGREE_TABLE.txt
1079,FOSL1,36,28,64,RPMI8226.H3K27ac_DEGREE_TABLE.txt
1080,FOXH1,24,34,58,RPMI8226.H3K27ac_DEGREE_TABLE.txt
1081,FOXO3,34,45,79,RPMI8226.H3K27ac_DEGREE_TABLE.txt
1082,FOXP2,40,37,77,RPMI8226.H3K27ac_DEGREE_TABLE.txt
1083,HBP1,33,40,73,RPMI8226.H3K27ac_DEGREE_TABLE.txt
1084,JUNB,43,37,80,RPMI8226.H3K27ac_DEGREE_TABLE.txt
1085,JUND,30,46,76,RPMI8226.H3K27ac_DEGREE_TABLE.txt
1086,KLF13,42,26,68,RPMI8226.H3K27ac_DEGREE_TABLE.txt
1087,KLF6,40,32,72,RPMI8226.H3K27ac_DEGREE_TABLE.txt
1088,LTF,41,28,69,RPMI8226.H3K27ac_DEGREE_TABLE.txt
1089,MAF,44,45,89,RPMI8226.H3K27ac_DEGREE_TABLE.txt
1090,MAZ,32,46,78,RPMI8226.H3K27ac_DEGREE_TABLE.txt
1091,MEF2D,30,40,70,RPMI8226.H3K27ac_DEGREE_TABLE.txt
1092,MYC,38,37,75,RPMI8226.H3K27ac_DEGREE_TABLE.txt
1093,NFE2L2,27,28,55,RPMI8226.H3K27ac_DEGREE_TABLE.txt
1094,NFE2L3,36,41,77,RPMI8226.H3K27ac_DEGREE_TABLE.txt
1095,NOTCH1,31,26,57,RPMI8226.H3K27ac_DEGREE_TABLE.txt
1096,SF1,35,27,62,RPMI8226.H3K27ac_DEGREE_TABLE.txt
1097,SIN3A,34,46,80,RPMI8226.H3K27ac_DEGREE_TABLE.txt
1098,SP3,23,46,69,RPMI8226.H3K27ac_DEGREE_TABLE.txt
1099,SREBF2,34,33,67,RPMI8226.H3K27ac_DEGREE_TABLE.txt
1100,TBX10,36,29,65,RPMI8226.H3K27ac_DEGREE_TABLE.txt
1101,TFAP4,32,31,63,RPMI8226.H3K27ac_DEGREE_TABLE.txt
1102,TGIF1,37,30,67,RPMI8226.H3K27ac_DEGREE_TABLE.txt
1103,XBP1,37,25,62,RPMI8226.H3K27ac_DEGREE_TABLE.txt
1104,ZBTB38,43,35,78,RPMI8226.H3K27ac_DEGREE_TABLE.txt
1105,ZBTB7B,45,36,81,RPMI8226.H3K27ac_DEGREE_TABLE.txt
1106,ZFP91,31,33,64,RPMI8226.H3K27ac_DEGREE_TABLE.txt
1107,ZNF423,31,29,60,RPMI8226.H3K27ac_DEGREE_TABLE.txt
1108,ZNF580,31,40,71,RPMI8226.H3K27ac_DEGREE_TABLE.txt
1109,ZNF581,31,38,69,RPMI8226.H3K27ac_DEGREE_TABLE.txt
1110,ZNF689,28,39,67,RPMI8226.H3K27ac_DEGREE_TABLE.txt
1111,ZNF775,44,38,82,RPMI8226.H3K27ac_DEGREE_TABLE.txt
1112,ZNF784,31,43,74,RPMI8226.H3K27ac_DEGREE_TABLE.txt
1113,AIRE,88,118,206,MM12.H3K27ac_DEGREE_TABLE.txt
1114,ARF1,121,31,152,MM12.H3K27ac_DEGREE_TABLE.txt
1115,ARF4,115,53,168,MM12.H3K27ac_DEGREE_TABLE.txt
1116,BACH1,123,88,211,MM12.H3K27ac_DEGREE_TABLE.txt
1117,BBX,101,127,228,MM12.H3K27ac_DEGREE_TABLE.txt
1118,BCL11A,126,144,270,MM12.H3K27ac_DEGREE_TABLE.txt
1119,BCL6B,117,139,256,MM12.H3K27ac_DEGREE_TABLE.txt
1120,BCLAF1,112,147,259,MM12.H3K27ac_DEGREE_TABLE.txt
1121,BHLHE41,134,53,187,MM12.H3K27ac_DEGREE_TABLE.txt
1122,BRCA1,113,33,146,MM12.H3K27ac_DEGREE_TABLE.txt
1123,CAMTA2,115,25,140,MM12.H3K27ac_DEGREE_TABLE.txt
1124,CEBPB,108,115,223,MM12.H3K27ac_DEGREE_TABLE.txt
1125,CEBPG,104,122,226,MM12.H3K27ac_DEGREE_TABLE.txt
1126,CHD2,133,128,261,MM12.H3K27ac_DEGREE_TABLE.txt
1127,CNOT3,92,118,210,MM12.H3K27ac_DEGREE_TABLE.txt
1128,CREB1,109,122,231,MM12.H3K27ac_DEGREE_TABLE.txt
1129,CREB3L2,124,108,232,MM12.H3K27ac_DEGREE_TABLE.txt
1130,CREM,104,94,198,MM12.H3K27ac_DEGREE_TABLE.txt
1131,CST6,103,49,152,MM12.H3K27ac_DEGREE_TABLE.txt
1132,CTCF,132,147,279,MM12.H3K27ac_DEGREE_TABLE.txt
1133,DBP,124,134,258,MM12.H3K27ac_DEGREE_TABLE.txt
1134,DDIT3,118,109,227,MM12.H3K27ac_DEGREE_TABLE.txt
1135,DEAF1,107,118,225,MM12.H3K27ac_DEGREE_TABLE.txt
1136,ERF,123,111,234,MM12.H3K27ac_DEGREE_TABLE.txt
1137,ESRRA,130,144,274,MM12.H3K27ac_DEGREE_TABLE.txt
1138,FIZ1,101,144,245,MM12.H3K27ac_DEGREE_TABLE.txt
1139,FLI1,110,144,254,MM12.H3K27ac_DEGREE_TABLE.txt
1140,FOSB,131,53,184,MM12.H3K27ac_DEGREE_TABLE.txt
1141,FOSL2,121,94,215,MM12.H3K27ac_DEGREE_TABLE.txt
1142,FOXN3,139,81,220,MM12.H3K27ac_DEGREE_TABLE.txt
1143,FOXO3,126,146,272,MM12.H3K27ac_DEGREE_TABLE.txt
1144,FOXP1,119,141,260,MM12.H3K27ac_DEGREE_TABLE.txt
1145,FOXP2,126,126,252,MM12.H3K27ac_DEGREE_TABLE.txt
1146,GFI1,117,136,253,MM12.H3K27ac_DEGREE_TABLE.txt
1147,GLIS3,114,86,200,MM12.H3K27ac_DEGREE_TABLE.txt
1148,GZF1,107,37,144,MM12.H3K27ac_DEGREE_TABLE.txt
1149,HAP1,106,14,120,MM12.H3K27ac_DEGREE_TABLE.txt
1150,HBP1,119,128,247,MM12.H3K27ac_DEGREE_TABLE.txt
1151,HES5,106,74,180,MM12.H3K27ac_DEGREE_TABLE.txt
1152,HES7,137,125,262,MM12.H3K27ac_DEGREE_TABLE.txt
1153,HEY1,119,51,170,MM12.H3K27ac_DEGREE_TABLE.txt
1154,HEY2,123,66,189,MM12.H3K27ac_DEGREE_TABLE.txt
1155,HIVEP2,130,119,249,MM12.H3K27ac_DEGREE_TABLE.txt
1156,IRF1,137,144,281,MM12.H3K27ac_DEGREE_TABLE.txt
1157,IRF2,119,116,235,MM12.H3K27ac_DEGREE_TABLE.txt
1158,IRF3,135,145,280,MM12.H3K27ac_DEGREE_TABLE.txt
1159,IRF4,141,129,270,MM12.H3K27ac_DEGREE_TABLE.txt
1160,IRF9,91,126,217,MM12.H3K27ac_DEGREE_TABLE.txt
1161,ISL2,112,129,241,MM12.H3K27ac_DEGREE_TABLE.txt
1162,JUN,109,129,238,MM12.H3K27ac_DEGREE_TABLE.txt
1163,JUNB,129,121,250,MM12.H3K27ac_DEGREE_TABLE.txt
1164,JUND,111,140,251,MM12.H3K27ac_DEGREE_TABLE.txt
1165,KLF10,108,142,250,MM12.H3K27ac_DEGREE_TABLE.txt
1166,KLF12,118,145,263,MM12.H3K27ac_DEGREE_TABLE.txt
1167,KLF13,143,87,230,MM12.H3K27ac_DEGREE_TABLE.txt
1168,KLF15,81,147,228,MM12.H3K27ac_DEGREE_TABLE.txt
1169,KLF2,135,132,267,MM12.H3K27ac_DEGREE_TABLE.txt
1170,KLF6,124,100,224,MM12.H3K27ac_DEGREE_TABLE.txt
1171,KLF7,99,147,246,MM12.H3K27ac_DEGREE_TABLE.txt
1172,KLF9,114,128,242,MM12.H3K27ac_DEGREE_TABLE.txt
1173,LHX6,107,116,223,MM12.H3K27ac_DEGREE_TABLE.txt
1174,MAFG,90,130,220,MM12.H3K27ac_DEGREE_TABLE.txt
1175,MEF2A,116,143,259,MM12.H3K27ac_DEGREE_TABLE.txt
1176,MEF2B,117,125,242,MM12.H3K27ac_DEGREE_TABLE.txt
1177,MEF2C,117,132,249,MM12.H3K27ac_DEGREE_TABLE.txt
1178,MNT,121,44,165,MM12.H3K27ac_DEGREE_TABLE.txt
1179,MYNN,98,80,178,MM12.H3K27ac_DEGREE_TABLE.txt
1180,MZF1,124,145,269,MM12.H3K27ac_DEGREE_TABLE.txt
1181,NFE2L2,132,100,232,MM12.H3K27ac_DEGREE_TABLE.txt
1182,NFE2L3,120,127,247,MM12.H3K27ac_DEGREE_TABLE.txt
1183,NFIL3,128,108,236,MM12.H3K27ac_DEGREE_TABLE.txt
1184,NFYA,117,109,226,MM12.H3K27ac_DEGREE_TABLE.txt
1185,NR1D2,118,82,200,MM12.H3K27ac_DEGREE_TABLE.txt
1186,NR2C2,97,144,241,MM12.H3K27ac_DEGREE_TABLE.txt
1187,NR3C1,132,124,256,MM12.H3K27ac_DEGREE_TABLE.txt
1188,NR4A2,130,133,263,MM12.H3K27ac_DEGREE_TABLE.txt
1189,NR4A3,120,81,201,MM12.H3K27ac_DEGREE_TABLE.txt
1190,NRL,97,82,179,MM12.H3K27ac_DEGREE_TABLE.txt
1191,PAX4,122,147,269,MM12.H3K27ac_DEGREE_TABLE.txt
1192,PAX5,141,147,288,MM12.H3K27ac_DEGREE_TABLE.txt
1193,PEG3,99,143,242,MM12.H3K27ac_DEGREE_TABLE.txt
1194,PRDM1,137,143,280,MM12.H3K27ac_DEGREE_TABLE.txt
1195,PRDM10,102,64,166,MM12.H3K27ac_DEGREE_TABLE.txt
1196,RARA,127,145,272,MM12.H3K27ac_DEGREE_TABLE.txt
1197,RAX2,102,67,169,MM12.H3K27ac_DEGREE_TABLE.txt
1198,RBPJ,104,116,220,MM12.H3K27ac_DEGREE_TABLE.txt
1199,RELA,127,145,272,MM12.H3K27ac_DEGREE_TABLE.txt
1200,RFX1,106,144,250,MM12.H3K27ac_DEGREE_TABLE.txt
1201,RFX3,118,127,245,MM12.H3K27ac_DEGREE_TABLE.txt
1202,RORA,95,131,226,MM12.H3K27ac_DEGREE_TABLE.txt
1203,RUNX1,128,104,232,MM12.H3K27ac_DEGREE_TABLE.txt
1204,RXRA,82,147,229,MM12.H3K27ac_DEGREE_TABLE.txt
1205,SF1,117,95,212,MM12.H3K27ac_DEGREE_TABLE.txt
1206,SIN3A,130,147,277,MM12.H3K27ac_DEGREE_TABLE.txt
1207,SIX5,97,138,235,MM12.H3K27ac_DEGREE_TABLE.txt
1208,SMAD7,128,109,237,MM12.H3K27ac_DEGREE_TABLE.txt
1209,SNAI3,101,109,210,MM12.H3K27ac_DEGREE_TABLE.txt
1210,SPI1,104,147,251,MM12.H3K27ac_DEGREE_TABLE.txt
1211,TCF12,100,137,237,MM12.H3K27ac_DEGREE_TABLE.txt
1212,TFEB,116,62,178,MM12.H3K27ac_DEGREE_TABLE.txt
1213,TGIF2,105,112,217,MM12.H3K27ac_DEGREE_TABLE.txt
1214,TP53,107,118,225,MM12.H3K27ac_DEGREE_TABLE.txt
1215,USF1,114,99,213,MM12.H3K27ac_DEGREE_TABLE.txt
1216,VSX1,126,110,236,MM12.H3K27ac_DEGREE_TABLE.txt
1217,XBP1,121,95,216,MM12.H3K27ac_DEGREE_TABLE.txt
1218,ZBTB1,118,72,190,MM12.H3K27ac_DEGREE_TABLE.txt
1219,ZBTB11,114,137,251,MM12.H3K27ac_DEGREE_TABLE.txt
1220,ZBTB20,115,88,203,MM12.H3K27ac_DEGREE_TABLE.txt
1221,ZBTB3,122,137,259,MM12.H3K27ac_DEGREE_TABLE.txt
1222,ZBTB32,94,90,184,MM12.H3K27ac_DEGREE_TABLE.txt
1223,ZBTB38,142,103,245,MM12.H3K27ac_DEGREE_TABLE.txt
1224,ZBTB7A,106,126,232,MM12.H3K27ac_DEGREE_TABLE.txt
1225,ZFP91,134,109,243,MM12.H3K27ac_DEGREE_TABLE.txt
1226,ZIM2,99,112,211,MM12.H3K27ac_DEGREE_TABLE.txt
1227,ZNF135,97,145,242,MM12.H3K27ac_DEGREE_TABLE.txt
1228,ZNF136,95,142,237,MM12.H3K27ac_DEGREE_TABLE.txt
1229,ZNF143,112,119,231,MM12.H3K27ac_DEGREE_TABLE.txt
1230,ZNF20,95,131,226,MM12.H3K27ac_DEGREE_TABLE.txt
1231,ZNF215,127,100,227,MM12.H3K27ac_DEGREE_TABLE.txt
1232,ZNF283,119,137,256,MM12.H3K27ac_DEGREE_TABLE.txt
1233,ZNF331,111,144,255,MM12.H3K27ac_DEGREE_TABLE.txt
1234,ZNF367,123,88,211,MM12.H3K27ac_DEGREE_TABLE.txt
1235,ZNF440,94,122,216,MM12.H3K27ac_DEGREE_TABLE.txt
1236,ZNF441,94,147,241,MM12.H3K27ac_DEGREE_TABLE.txt
1237,ZNF460,115,147,262,MM12.H3K27ac_DEGREE_TABLE.txt
1238,ZNF483,113,121,234,MM12.H3K27ac_DEGREE_TABLE.txt
1239,ZNF490,117,93,210,MM12.H3K27ac_DEGREE_TABLE.txt
1240,ZNF491,94,127,221,MM12.H3K27ac_DEGREE_TABLE.txt
1241,ZNF497,96,124,220,MM12.H3K27ac_DEGREE_TABLE.txt
1242,ZNF524,101,138,239,MM12.H3K27ac_DEGREE_TABLE.txt
1243,ZNF526,123,137,260,MM12.H3K27ac_DEGREE_TABLE.txt
1244,ZNF543,115,141,256,MM12.H3K27ac_DEGREE_TABLE.txt
1245,ZNF554,119,88,207,MM12.H3K27ac_DEGREE_TABLE.txt
1246,ZNF574,103,143,246,MM12.H3K27ac_DEGREE_TABLE.txt
1247,ZNF580,126,127,253,MM12.H3K27ac_DEGREE_TABLE.txt
1248,ZNF581,126,118,244,MM12.H3K27ac_DEGREE_TABLE.txt
1249,ZNF584,96,98,194,MM12.H3K27ac_DEGREE_TABLE.txt
1250,ZNF592,101,47,148,MM12.H3K27ac_DEGREE_TABLE.txt
1251,ZNF625,95,103,198,MM12.H3K27ac_DEGREE_TABLE.txt
1252,ZNF627,99,119,218,MM12.H3K27ac_DEGREE_TABLE.txt
1253,ZNF784,126,133,259,MM12.H3K27ac_DEGREE_TABLE.txt
1254,ZNF791,117,113,230,MM12.H3K27ac_DEGREE_TABLE.txt
1255,ZNF805,115,135,250,MM12.H3K27ac_DEGREE_TABLE.txt
1256,ZNF823,94,145,239,MM12.H3K27ac_DEGREE_TABLE.txt
1257,ZNF837,96,144,240,MM12.H3K27ac_DEGREE_TABLE.txt
1258,ZNF860,122,142,264,MM12.H3K27ac_DEGREE_TABLE.txt
1259,ZSCAN18,97,53,150,MM12.H3K27ac_DEGREE_TABLE.txt
1260,ARF1,93,39,132,MM14.H3K27ac_DEGREE_TABLE.txt
1261,ARF4,99,52,151,MM14.H3K27ac_DEGREE_TABLE.txt
1262,ARF5,67,41,108,MM14.H3K27ac_DEGREE_TABLE.txt
1263,ARID5A,106,103,209,MM14.H3K27ac_DEGREE_TABLE.txt
1264,ATF5,114,109,223,MM14.H3K27ac_DEGREE_TABLE.txt
1265,BARX2,116,100,216,MM14.H3K27ac_DEGREE_TABLE.txt
1266,BCL6B,99,117,216,MM14.H3K27ac_DEGREE_TABLE.txt
1267,BHLHA15,80,86,166,MM14.H3K27ac_DEGREE_TABLE.txt
1268,BHLHE41,114,56,170,MM14.H3K27ac_DEGREE_TABLE.txt
1269,CAMTA2,108,28,136,MM14.H3K27ac_DEGREE_TABLE.txt
1270,CEBPG,82,100,182,MM14.H3K27ac_DEGREE_TABLE.txt
1271,CHD2,109,113,222,MM14.H3K27ac_DEGREE_TABLE.txt
1272,CNOT3,76,99,175,MM14.H3K27ac_DEGREE_TABLE.txt
1273,CREB1,97,108,205,MM14.H3K27ac_DEGREE_TABLE.txt
1274,CREB3L2,114,94,208,MM14.H3K27ac_DEGREE_TABLE.txt
1275,DMRTC2,114,74,188,MM14.H3K27ac_DEGREE_TABLE.txt
1276,ERF,105,97,202,MM14.H3K27ac_DEGREE_TABLE.txt
1277,ESRRA,105,118,223,MM14.H3K27ac_DEGREE_TABLE.txt
1278,FIZ1,107,115,222,MM14.H3K27ac_DEGREE_TABLE.txt
1279,FLI1,98,115,213,MM14.H3K27ac_DEGREE_TABLE.txt
1280,FOSB,110,62,172,MM14.H3K27ac_DEGREE_TABLE.txt
1281,FOXO3,105,115,220,MM14.H3K27ac_DEGREE_TABLE.txt
1282,FOXP2,101,103,204,MM14.H3K27ac_DEGREE_TABLE.txt
1283,HBP1,101,113,214,MM14.H3K27ac_DEGREE_TABLE.txt
1284,HES1,106,106,212,MM14.H3K27ac_DEGREE_TABLE.txt
1285,HES5,103,79,182,MM14.H3K27ac_DEGREE_TABLE.txt
1286,HES7,109,110,219,MM14.H3K27ac_DEGREE_TABLE.txt
1287,IKZF1,116,108,224,MM14.H3K27ac_DEGREE_TABLE.txt
1288,IRF1,115,116,231,MM14.H3K27ac_DEGREE_TABLE.txt
1289,IRF3,110,117,227,MM14.H3K27ac_DEGREE_TABLE.txt
1290,IRF4,113,114,227,MM14.H3K27ac_DEGREE_TABLE.txt
1291,JUNB,115,108,223,MM14.H3K27ac_DEGREE_TABLE.txt
1292,JUND,91,117,208,MM14.H3K27ac_DEGREE_TABLE.txt
1293,KLF10,96,115,211,MM14.H3K27ac_DEGREE_TABLE.txt
1294,KLF13,117,80,197,MM14.H3K27ac_DEGREE_TABLE.txt
1295,KLF15,67,118,185,MM14.H3K27ac_DEGREE_TABLE.txt
1296,KLF16,95,113,208,MM14.H3K27ac_DEGREE_TABLE.txt
1297,KLF2,100,111,211,MM14.H3K27ac_DEGREE_TABLE.txt
1298,KLF6,106,91,197,MM14.H3K27ac_DEGREE_TABLE.txt
1299,KLF9,110,114,224,MM14.H3K27ac_DEGREE_TABLE.txt
1300,LHX6,86,103,189,MM14.H3K27ac_DEGREE_TABLE.txt
1301,MECP2,103,76,179,MM14.H3K27ac_DEGREE_TABLE.txt
1302,MEF2A,94,117,211,MM14.H3K27ac_DEGREE_TABLE.txt
1303,MEF2C,105,113,218,MM14.H3K27ac_DEGREE_TABLE.txt
1304,MEF2D,112,112,224,MM14.H3K27ac_DEGREE_TABLE.txt
1305,MNT,109,58,167,MM14.H3K27ac_DEGREE_TABLE.txt
1306,MYNN,80,81,161,MM14.H3K27ac_DEGREE_TABLE.txt
1307,MZF1,109,117,226,MM14.H3K27ac_DEGREE_TABLE.txt
1308,NFE2L2,93,89,182,MM14.H3K27ac_DEGREE_TABLE.txt
1309,NFE2L3,109,113,222,MM14.H3K27ac_DEGREE_TABLE.txt
1310,NFIL3,102,93,195,MM14.H3K27ac_DEGREE_TABLE.txt
1311,NFKB1,89,116,205,MM14.H3K27ac_DEGREE_TABLE.txt
1312,NFKB2,101,103,204,MM14.H3K27ac_DEGREE_TABLE.txt
1313,NR1D1,112,113,225,MM14.H3K27ac_DEGREE_TABLE.txt
1314,NR1D2,98,83,181,MM14.H3K27ac_DEGREE_TABLE.txt
1315,NR1H2,72,96,168,MM14.H3K27ac_DEGREE_TABLE.txt
1316,NR3C1,110,107,217,MM14.H3K27ac_DEGREE_TABLE.txt
1317,NR4A3,102,83,185,MM14.H3K27ac_DEGREE_TABLE.txt
1318,OVOL1,92,85,177,MM14.H3K27ac_DEGREE_TABLE.txt
1319,PAX4,104,118,222,MM14.H3K27ac_DEGREE_TABLE.txt
1320,PBX2,102,93,195,MM14.H3K27ac_DEGREE_TABLE.txt
1321,PBX4,108,91,199,MM14.H3K27ac_DEGREE_TABLE.txt
1322,POU2F2,107,118,225,MM14.H3K27ac_DEGREE_TABLE.txt
1323,POU5F1,105,115,220,MM14.H3K27ac_DEGREE_TABLE.txt
1324,PRDM1,114,115,229,MM14.H3K27ac_DEGREE_TABLE.txt
1325,PRDM10,83,70,153,MM14.H3K27ac_DEGREE_TABLE.txt
1326,RARA,114,118,232,MM14.H3K27ac_DEGREE_TABLE.txt
1327,RAX2,78,62,140,MM14.H3K27ac_DEGREE_TABLE.txt
1328,RELA,94,118,212,MM14.H3K27ac_DEGREE_TABLE.txt
1329,RELB,85,79,164,MM14.H3K27ac_DEGREE_TABLE.txt
1330,RFX1,82,113,195,MM14.H3K27ac_DEGREE_TABLE.txt
1331,RFX3,99,110,209,MM14.H3K27ac_DEGREE_TABLE.txt
1332,RORA,86,115,201,MM14.H3K27ac_DEGREE_TABLE.txt
1333,RUNX1,103,96,199,MM14.H3K27ac_DEGREE_TABLE.txt
1334,RXRB,100,110,210,MM14.H3K27ac_DEGREE_TABLE.txt
1335,SIN3A,105,116,221,MM14.H3K27ac_DEGREE_TABLE.txt
1336,SMAD7,115,100,215,MM14.H3K27ac_DEGREE_TABLE.txt
1337,SNAPC4,97,87,184,MM14.H3K27ac_DEGREE_TABLE.txt
1338,SPIB,72,117,189,MM14.H3K27ac_DEGREE_TABLE.txt
1339,TCF12,98,113,211,MM14.H3K27ac_DEGREE_TABLE.txt
1340,TFEB,94,67,161,MM14.H3K27ac_DEGREE_TABLE.txt
1341,TGIF2,96,96,192,MM14.H3K27ac_DEGREE_TABLE.txt
1342,THRA,112,108,220,MM14.H3K27ac_DEGREE_TABLE.txt
1343,XBP1,100,91,191,MM14.H3K27ac_DEGREE_TABLE.txt
1344,ZBTB1,105,68,173,MM14.H3K27ac_DEGREE_TABLE.txt
1345,ZBTB3,93,110,203,MM14.H3K27ac_DEGREE_TABLE.txt
1346,ZBTB32,103,74,177,MM14.H3K27ac_DEGREE_TABLE.txt
1347,ZBTB38,117,90,207,MM14.H3K27ac_DEGREE_TABLE.txt
1348,ZBTB7A,102,107,209,MM14.H3K27ac_DEGREE_TABLE.txt
1349,ZFP91,109,104,213,MM14.H3K27ac_DEGREE_TABLE.txt
1350,ZFX,85,118,203,MM14.H3K27ac_DEGREE_TABLE.txt
1351,ZKSCAN1,74,106,180,MM14.H3K27ac_DEGREE_TABLE.txt
1352,ZNF114,104,68,172,MM14.H3K27ac_DEGREE_TABLE.txt
1353,ZNF283,105,116,221,MM14.H3K27ac_DEGREE_TABLE.txt
1354,ZNF331,95,117,212,MM14.H3K27ac_DEGREE_TABLE.txt
1355,ZNF444,75,105,180,MM14.H3K27ac_DEGREE_TABLE.txt
1356,ZNF460,108,118,226,MM14.H3K27ac_DEGREE_TABLE.txt
1357,ZNF483,83,108,191,MM14.H3K27ac_DEGREE_TABLE.txt
1358,ZNF497,93,109,202,MM14.H3K27ac_DEGREE_TABLE.txt
1359,ZNF524,107,114,221,MM14.H3K27ac_DEGREE_TABLE.txt
1360,ZNF526,105,109,214,MM14.H3K27ac_DEGREE_TABLE.txt
1361,ZNF541,84,103,187,MM14.H3K27ac_DEGREE_TABLE.txt
1362,ZNF542,81,102,183,MM14.H3K27ac_DEGREE_TABLE.txt
1363,ZNF543,108,115,223,MM14.H3K27ac_DEGREE_TABLE.txt
1364,ZNF574,110,115,225,MM14.H3K27ac_DEGREE_TABLE.txt
1365,ZNF580,112,111,223,MM14.H3K27ac_DEGREE_TABLE.txt
1366,ZNF581,112,98,210,MM14.H3K27ac_DEGREE_TABLE.txt
1367,ZNF584,93,83,176,MM14.H3K27ac_DEGREE_TABLE.txt
1368,ZNF592,98,44,142,MM14.H3K27ac_DEGREE_TABLE.txt
1369,ZNF689,106,102,208,MM14.H3K27ac_DEGREE_TABLE.txt
1370,ZNF710,115,103,218,MM14.H3K27ac_DEGREE_TABLE.txt
1371,ZNF774,77,112,189,MM14.H3K27ac_DEGREE_TABLE.txt
1372,ZNF775,108,111,219,MM14.H3K27ac_DEGREE_TABLE.txt
1373,ZNF784,112,112,224,MM14.H3K27ac_DEGREE_TABLE.txt
1374,ZNF787,75,97,172,MM14.H3K27ac_DEGREE_TABLE.txt
1375,ZNF805,108,112,220,MM14.H3K27ac_DEGREE_TABLE.txt
1376,ZNF837,93,112,205,MM14.H3K27ac_DEGREE_TABLE.txt
1377,ZSCAN21,74,108,182,MM14.H3K27ac_DEGREE_TABLE.txt
1378,ARF1,112,51,163,MM6_jia_DEGREE_TABLE.txt
1379,ARF4,107,55,162,MM6_jia_DEGREE_TABLE.txt
1380,ARID3A,115,104,219,MM6_jia_DEGREE_TABLE.txt
1381,ARID5A,112,108,220,MM6_jia_DEGREE_TABLE.txt
1382,ATF4,106,110,216,MM6_jia_DEGREE_TABLE.txt
1383,BCL6,93,126,219,MM6_jia_DEGREE_TABLE.txt
1384,BCLAF1,94,128,222,MM6_jia_DEGREE_TABLE.txt
1385,BHLHE40,105,85,190,MM6_jia_DEGREE_TABLE.txt
1386,BHLHE41,121,58,179,MM6_jia_DEGREE_TABLE.txt
1387,BRCA1,95,39,134,MM6_jia_DEGREE_TABLE.txt
1388,CAMTA2,112,19,131,MM6_jia_DEGREE_TABLE.txt
1389,CHD2,116,120,236,MM6_jia_DEGREE_TABLE.txt
1390,CREB3L2,111,100,211,MM6_jia_DEGREE_TABLE.txt
1391,CREB3L4,114,97,211,MM6_jia_DEGREE_TABLE.txt
1392,CREM,93,93,186,MM6_jia_DEGREE_TABLE.txt
1393,CTCFL,118,125,243,MM6_jia_DEGREE_TABLE.txt
1394,CUX1,107,92,199,MM6_jia_DEGREE_TABLE.txt
1395,DBP,107,110,217,MM6_jia_DEGREE_TABLE.txt
1396,DDIT3,100,105,205,MM6_jia_DEGREE_TABLE.txt
1397,ELF2,82,105,187,MM6_jia_DEGREE_TABLE.txt
1398,ELK4,94,115,209,MM6_jia_DEGREE_TABLE.txt
1399,ERF,118,103,221,MM6_jia_DEGREE_TABLE.txt
1400,ETV1,120,122,242,MM6_jia_DEGREE_TABLE.txt
1401,FIZ1,91,124,215,MM6_jia_DEGREE_TABLE.txt
1402,FLI1,118,127,245,MM6_jia_DEGREE_TABLE.txt
1403,FOS,107,105,212,MM6_jia_DEGREE_TABLE.txt
1404,FOSB,115,49,164,MM6_jia_DEGREE_TABLE.txt
1405,FOXO3,115,125,240,MM6_jia_DEGREE_TABLE.txt
1406,FOXP2,105,112,217,MM6_jia_DEGREE_TABLE.txt
1407,GZF1,110,44,154,MM6_jia_DEGREE_TABLE.txt
1408,HAP1,99,14,113,MM6_jia_DEGREE_TABLE.txt
1409,HBP1,101,113,214,MM6_jia_DEGREE_TABLE.txt
1410,HES5,107,71,178,MM6_jia_DEGREE_TABLE.txt
1411,HES7,119,123,242,MM6_jia_DEGREE_TABLE.txt
1412,HIVEP2,113,106,219,MM6_jia_DEGREE_TABLE.txt
1413,IKZF1,116,115,231,MM6_jia_DEGREE_TABLE.txt
1414,IKZF3,114,128,242,MM6_jia_DEGREE_TABLE.txt
1415,IRF1,112,127,239,MM6_jia_DEGREE_TABLE.txt
1416,IRF2,121,102,223,MM6_jia_DEGREE_TABLE.txt
1417,IRF3,116,125,241,MM6_jia_DEGREE_TABLE.txt
1418,IRF9,107,115,222,MM6_jia_DEGREE_TABLE.txt
1419,JUN,100,113,213,MM6_jia_DEGREE_TABLE.txt
1420,JUNB,112,107,219,MM6_jia_DEGREE_TABLE.txt
1421,JUND,98,127,225,MM6_jia_DEGREE_TABLE.txt
1422,KLF1,122,126,248,MM6_jia_DEGREE_TABLE.txt
1423,KLF13,124,88,212,MM6_jia_DEGREE_TABLE.txt
1424,KLF16,71,118,189,MM6_jia_DEGREE_TABLE.txt
1425,KLF2,121,123,244,MM6_jia_DEGREE_TABLE.txt
1426,KLF3,115,121,236,MM6_jia_DEGREE_TABLE.txt
1427,KLF6,118,115,233,MM6_jia_DEGREE_TABLE.txt
1428,KLF9,114,121,235,MM6_jia_DEGREE_TABLE.txt
1429,MAF,109,124,233,MM6_jia_DEGREE_TABLE.txt
1430,MEF2C,125,119,244,MM6_jia_DEGREE_TABLE.txt
1431,MEF2D,120,106,226,MM6_jia_DEGREE_TABLE.txt
1432,MEIS2,119,116,235,MM6_jia_DEGREE_TABLE.txt
1433,MNT,102,54,156,MM6_jia_DEGREE_TABLE.txt
1434,MYNN,92,78,170,MM6_jia_DEGREE_TABLE.txt
1435,MZF1,107,127,234,MM6_jia_DEGREE_TABLE.txt
1436,NFE2L2,115,90,205,MM6_jia_DEGREE_TABLE.txt
1437,NFE2L3,108,115,223,MM6_jia_DEGREE_TABLE.txt
1438,NFIL3,112,94,206,MM6_jia_DEGREE_TABLE.txt
1439,NFIX,122,107,229,MM6_jia_DEGREE_TABLE.txt
1440,NFKB2,95,112,207,MM6_jia_DEGREE_TABLE.txt
1441,NR1D1,118,122,240,MM6_jia_DEGREE_TABLE.txt
1442,NR1D2,103,77,180,MM6_jia_DEGREE_TABLE.txt
1443,NR2C2,94,128,222,MM6_jia_DEGREE_TABLE.txt
1444,NR3C1,115,114,229,MM6_jia_DEGREE_TABLE.txt
1445,NR4A2,110,120,230,MM6_jia_DEGREE_TABLE.txt
1446,PAX4,97,128,225,MM6_jia_DEGREE_TABLE.txt
1447,PBX2,107,86,193,MM6_jia_DEGREE_TABLE.txt
1448,PBX4,110,89,199,MM6_jia_DEGREE_TABLE.txt
1449,POU2F1,96,127,223,MM6_jia_DEGREE_TABLE.txt
1450,POU5F1,101,122,223,MM6_jia_DEGREE_TABLE.txt
1451,PRDM1,123,125,248,MM6_jia_DEGREE_TABLE.txt
1452,PRDM10,86,85,171,MM6_jia_DEGREE_TABLE.txt
1453,RARA,107,128,235,MM6_jia_DEGREE_TABLE.txt
1454,RAX2,88,56,144,MM6_jia_DEGREE_TABLE.txt
1455,RELB,69,95,164,MM6_jia_DEGREE_TABLE.txt
1456,RFX1,107,122,229,MM6_jia_DEGREE_TABLE.txt
1457,RFX3,101,118,219,MM6_jia_DEGREE_TABLE.txt
1458,RREB1,111,128,239,MM6_jia_DEGREE_TABLE.txt
1459,RXRB,97,117,214,MM6_jia_DEGREE_TABLE.txt
1460,SIN3A,110,128,238,MM6_jia_DEGREE_TABLE.txt
1461,SOX11,108,126,234,MM6_jia_DEGREE_TABLE.txt
1462,SP3,95,127,222,MM6_jia_DEGREE_TABLE.txt
1463,SP4,80,128,208,MM6_jia_DEGREE_TABLE.txt
1464,TCF3,107,128,235,MM6_jia_DEGREE_TABLE.txt
1465,TFEC,113,94,207,MM6_jia_DEGREE_TABLE.txt
1466,THRA,118,117,235,MM6_jia_DEGREE_TABLE.txt
1467,USF1,93,103,196,MM6_jia_DEGREE_TABLE.txt
1468,XBP1,118,83,201,MM6_jia_DEGREE_TABLE.txt
1469,ZBED6,112,91,203,MM6_jia_DEGREE_TABLE.txt
1470,ZBTB1,106,81,187,MM6_jia_DEGREE_TABLE.txt
1471,ZBTB20,89,89,178,MM6_jia_DEGREE_TABLE.txt
1472,ZBTB32,111,80,191,MM6_jia_DEGREE_TABLE.txt
1473,ZBTB38,126,105,231,MM6_jia_DEGREE_TABLE.txt
1474,ZBTB7A,111,120,231,MM6_jia_DEGREE_TABLE.txt
1475,ZBTB7B,126,116,242,MM6_jia_DEGREE_TABLE.txt
1476,ZFP62,107,125,232,MM6_jia_DEGREE_TABLE.txt
1477,ZFP91,99,101,200,MM6_jia_DEGREE_TABLE.txt
1478,ZKSCAN5,95,121,216,MM6_jia_DEGREE_TABLE.txt
1479,ZNF114,118,71,189,MM6_jia_DEGREE_TABLE.txt
1480,ZNF131,80,106,186,MM6_jia_DEGREE_TABLE.txt
1481,ZNF217,118,63,181,MM6_jia_DEGREE_TABLE.txt
1482,ZNF276,85,126,211,MM6_jia_DEGREE_TABLE.txt
1483,ZNF367,104,92,196,MM6_jia_DEGREE_TABLE.txt
1484,ZNF394,95,124,219,MM6_jia_DEGREE_TABLE.txt
1485,ZNF460,103,128,231,MM6_jia_DEGREE_TABLE.txt
1486,ZNF490,101,98,199,MM6_jia_DEGREE_TABLE.txt
1487,ZNF524,91,124,215,MM6_jia_DEGREE_TABLE.txt
1488,ZNF526,106,123,229,MM6_jia_DEGREE_TABLE.txt
1489,ZNF542,84,106,190,MM6_jia_DEGREE_TABLE.txt
1490,ZNF543,103,124,227,MM6_jia_DEGREE_TABLE.txt
1491,ZNF554,100,90,190,MM6_jia_DEGREE_TABLE.txt
1492,ZNF579,91,122,213,MM6_jia_DEGREE_TABLE.txt
1493,ZNF580,107,122,229,MM6_jia_DEGREE_TABLE.txt
1494,ZNF581,107,105,212,MM6_jia_DEGREE_TABLE.txt
1495,ZNF592,95,61,156,MM6_jia_DEGREE_TABLE.txt
1496,ZNF672,85,125,210,MM6_jia_DEGREE_TABLE.txt
1497,ZNF687,80,64,144,MM6_jia_DEGREE_TABLE.txt
1498,ZNF689,82,119,201,MM6_jia_DEGREE_TABLE.txt
1499,ZNF692,85,118,203,MM6_jia_DEGREE_TABLE.txt
1500,ZNF774,86,123,209,MM6_jia_DEGREE_TABLE.txt
1501,ZNF775,112,121,233,MM6_jia_DEGREE_TABLE.txt
1502,ZNF784,107,118,225,MM6_jia_DEGREE_TABLE.txt
1503,ZNF789,95,110,205,MM6_jia_DEGREE_TABLE.txt
1504,ZNF791,101,94,195,MM6_jia_DEGREE_TABLE.txt
1505,ZNF805,103,124,227,MM6_jia_DEGREE_TABLE.txt
1506,ARID5A,36,41,77,EJM.H3K27ac_DEGREE_TABLE.txt
1507,BCLAF1,38,47,85,EJM.H3K27ac_DEGREE_TABLE.txt
1508,BRCA1,38,10,48,EJM.H3K27ac_DEGREE_TABLE.txt
1509,E2F2,42,39,81,EJM.H3K27ac_DEGREE_TABLE.txt
1510,E2F3,36,46,82,EJM.H3K27ac_DEGREE_TABLE.txt
1511,FEZF1,47,39,86,EJM.H3K27ac_DEGREE_TABLE.txt
1512,FLI1,45,47,92,EJM.H3K27ac_DEGREE_TABLE.txt
1513,FOSL1,43,30,73,EJM.H3K27ac_DEGREE_TABLE.txt
1514,HBP1,33,46,79,EJM.H3K27ac_DEGREE_TABLE.txt
1515,IKZF1,46,47,93,EJM.H3K27ac_DEGREE_TABLE.txt
1516,IRF2,37,37,74,EJM.H3K27ac_DEGREE_TABLE.txt
1517,IRF5,37,44,81,EJM.H3K27ac_DEGREE_TABLE.txt
1518,JUNB,39,42,81,EJM.H3K27ac_DEGREE_TABLE.txt
1519,JUND,30,47,77,EJM.H3K27ac_DEGREE_TABLE.txt
1520,KLF13,37,28,65,EJM.H3K27ac_DEGREE_TABLE.txt
1521,KLF2,45,45,90,EJM.H3K27ac_DEGREE_TABLE.txt
1522,KLF6,43,42,85,EJM.H3K27ac_DEGREE_TABLE.txt
1523,LHX8,40,42,82,EJM.H3K27ac_DEGREE_TABLE.txt
1524,MAZ,37,47,84,EJM.H3K27ac_DEGREE_TABLE.txt
1525,MEF2D,44,39,83,EJM.H3K27ac_DEGREE_TABLE.txt
1526,MYBL2,43,32,75,EJM.H3K27ac_DEGREE_TABLE.txt
1527,MYC,47,38,85,EJM.H3K27ac_DEGREE_TABLE.txt
1528,NFIL3,43,28,71,EJM.H3K27ac_DEGREE_TABLE.txt
1529,NR3C1,43,44,87,EJM.H3K27ac_DEGREE_TABLE.txt
1530,PBX2,33,34,67,EJM.H3K27ac_DEGREE_TABLE.txt
1531,PBX4,39,31,70,EJM.H3K27ac_DEGREE_TABLE.txt
1532,POU2F1,39,45,84,EJM.H3K27ac_DEGREE_TABLE.txt
1533,RARG,46,46,92,EJM.H3K27ac_DEGREE_TABLE.txt
1534,RFX3,36,44,80,EJM.H3K27ac_DEGREE_TABLE.txt
1535,RUNX1,44,37,81,EJM.H3K27ac_DEGREE_TABLE.txt
1536,SP3,30,47,77,EJM.H3K27ac_DEGREE_TABLE.txt
1537,TBX6,36,35,71,EJM.H3K27ac_DEGREE_TABLE.txt
1538,TCF3,43,47,90,EJM.H3K27ac_DEGREE_TABLE.txt
1539,TCF4,42,38,80,EJM.H3K27ac_DEGREE_TABLE.txt
1540,TFAP4,34,37,71,EJM.H3K27ac_DEGREE_TABLE.txt
1541,VSX1,43,39,82,EJM.H3K27ac_DEGREE_TABLE.txt
1542,ZBTB38,46,38,84,EJM.H3K27ac_DEGREE_TABLE.txt
1543,ZBTB7B,40,41,81,EJM.H3K27ac_DEGREE_TABLE.txt
1544,ZFP62,35,47,82,EJM.H3K27ac_DEGREE_TABLE.txt
1545,ZFP91,45,40,85,EJM.H3K27ac_DEGREE_TABLE.txt
1546,ZNF217,45,30,75,EJM.H3K27ac_DEGREE_TABLE.txt
1547,ZNF267,44,47,91,EJM.H3K27ac_DEGREE_TABLE.txt
1548,ZNF280B,37,28,65,EJM.H3K27ac_DEGREE_TABLE.txt
1549,ZNF655,27,45,72,EJM.H3K27ac_DEGREE_TABLE.txt
1550,ZNF689,34,43,77,EJM.H3K27ac_DEGREE_TABLE.txt
1551,ZNF740,46,47,93,EJM.H3K27ac_DEGREE_TABLE.txt
1552,ZNF775,43,43,86,EJM.H3K27ac_DEGREE_TABLE.txt
1553,ARF1,122,50,172,MM3_jia_DEGREE_TABLE.txt
1554,ARID3A,132,126,258,MM3_jia_DEGREE_TABLE.txt
1555,ARID3B,118,123,241,MM3_jia_DEGREE_TABLE.txt
1556,ATF4,134,130,264,MM3_jia_DEGREE_TABLE.txt
1557,ATF6,125,103,228,MM3_jia_DEGREE_TABLE.txt
1558,BACH1,121,117,238,MM3_jia_DEGREE_TABLE.txt
1559,BCL11A,129,136,265,MM3_jia_DEGREE_TABLE.txt
1560,BCL6B,115,135,250,MM3_jia_DEGREE_TABLE.txt
1561,BCLAF1,104,135,239,MM3_jia_DEGREE_TABLE.txt
1562,BHLHA15,133,125,258,MM3_jia_DEGREE_TABLE.txt
1563,BHLHE41,135,87,222,MM3_jia_DEGREE_TABLE.txt
1564,CAD,115,135,250,MM3_jia_DEGREE_TABLE.txt
1565,CAMTA2,126,40,166,MM3_jia_DEGREE_TABLE.txt
1566,CENPB,115,75,190,MM3_jia_DEGREE_TABLE.txt
1567,CHD2,116,133,249,MM3_jia_DEGREE_TABLE.txt
1568,CREB3L2,133,119,252,MM3_jia_DEGREE_TABLE.txt
1569,CREM,112,116,228,MM3_jia_DEGREE_TABLE.txt
1570,CTCF,131,136,267,MM3_jia_DEGREE_TABLE.txt
1571,CUX1,135,108,243,MM3_jia_DEGREE_TABLE.txt
1572,DDIT3,122,129,251,MM3_jia_DEGREE_TABLE.txt
1573,DMRTC2,123,97,220,MM3_jia_DEGREE_TABLE.txt
1574,E2F1,122,132,254,MM3_jia_DEGREE_TABLE.txt
1575,E2F3,129,136,265,MM3_jia_DEGREE_TABLE.txt
1576,ETV5,112,107,219,MM3_jia_DEGREE_TABLE.txt
1577,FIZ1,129,136,265,MM3_jia_DEGREE_TABLE.txt
1578,FLI1,132,135,267,MM3_jia_DEGREE_TABLE.txt
1579,FOSB,134,80,214,MM3_jia_DEGREE_TABLE.txt
1580,FOSL1,129,114,243,MM3_jia_DEGREE_TABLE.txt
1581,FOXH1,117,122,239,MM3_jia_DEGREE_TABLE.txt
1582,FOXN3,132,113,245,MM3_jia_DEGREE_TABLE.txt
1583,FOXO3,131,136,267,MM3_jia_DEGREE_TABLE.txt
1584,FOXP2,116,127,243,MM3_jia_DEGREE_TABLE.txt
1585,FOXR1,103,131,234,MM3_jia_DEGREE_TABLE.txt
1586,GLI1,117,132,249,MM3_jia_DEGREE_TABLE.txt
1587,GZF1,127,72,199,MM3_jia_DEGREE_TABLE.txt
1588,HBP1,110,134,244,MM3_jia_DEGREE_TABLE.txt
1589,HES7,130,134,264,MM3_jia_DEGREE_TABLE.txt
1590,HEY2,118,101,219,MM3_jia_DEGREE_TABLE.txt
1591,HINFP,127,130,257,MM3_jia_DEGREE_TABLE.txt
1592,HIVEP2,134,126,260,MM3_jia_DEGREE_TABLE.txt
1593,IKZF1,130,132,262,MM3_jia_DEGREE_TABLE.txt
1594,IKZF3,134,136,270,MM3_jia_DEGREE_TABLE.txt
1595,IRF1,136,136,272,MM3_jia_DEGREE_TABLE.txt
1596,IRF2,134,122,256,MM3_jia_DEGREE_TABLE.txt
1597,IRF3,119,135,254,MM3_jia_DEGREE_TABLE.txt
1598,IRF4,134,128,262,MM3_jia_DEGREE_TABLE.txt
1599,IRF9,131,131,262,MM3_jia_DEGREE_TABLE.txt
1600,JUN,108,132,240,MM3_jia_DEGREE_TABLE.txt
1601,JUNB,133,128,261,MM3_jia_DEGREE_TABLE.txt
1602,JUND,102,136,238,MM3_jia_DEGREE_TABLE.txt
1603,KLF1,129,136,265,MM3_jia_DEGREE_TABLE.txt
1604,KLF10,127,136,263,MM3_jia_DEGREE_TABLE.txt
1605,KLF12,132,136,268,MM3_jia_DEGREE_TABLE.txt
1606,KLF13,134,110,244,MM3_jia_DEGREE_TABLE.txt
1607,KLF16,114,135,249,MM3_jia_DEGREE_TABLE.txt
1608,KLF3,126,134,260,MM3_jia_DEGREE_TABLE.txt
1609,KLF6,129,132,261,MM3_jia_DEGREE_TABLE.txt
1610,MEF2B,133,135,268,MM3_jia_DEGREE_TABLE.txt
1611,MEF2C,134,133,267,MM3_jia_DEGREE_TABLE.txt
1612,MEF2D,130,130,260,MM3_jia_DEGREE_TABLE.txt
1613,MLXIP,129,87,216,MM3_jia_DEGREE_TABLE.txt
1614,MNT,125,89,214,MM3_jia_DEGREE_TABLE.txt
1615,MYBL2,117,105,222,MM3_jia_DEGREE_TABLE.txt
1616,MYNN,116,111,227,MM3_jia_DEGREE_TABLE.txt
1617,MZF1,126,135,261,MM3_jia_DEGREE_TABLE.txt
1618,NFE2L1,116,116,232,MM3_jia_DEGREE_TABLE.txt
1619,NFE2L2,125,118,243,MM3_jia_DEGREE_TABLE.txt
1620,NFE2L3,126,133,259,MM3_jia_DEGREE_TABLE.txt
1621,NFIX,129,128,257,MM3_jia_DEGREE_TABLE.txt
1622,NFKB2,107,133,240,MM3_jia_DEGREE_TABLE.txt
1623,NR1D1,136,136,272,MM3_jia_DEGREE_TABLE.txt
1624,NR1D2,122,116,238,MM3_jia_DEGREE_TABLE.txt
1625,NR3C1,123,127,250,MM3_jia_DEGREE_TABLE.txt
1626,NR4A2,124,134,258,MM3_jia_DEGREE_TABLE.txt
1627,NR4A3,108,102,210,MM3_jia_DEGREE_TABLE.txt
1628,PAX5,133,136,269,MM3_jia_DEGREE_TABLE.txt
1629,PBX2,109,113,222,MM3_jia_DEGREE_TABLE.txt
1630,POU5F1,116,135,251,MM3_jia_DEGREE_TABLE.txt
1631,PPARA,95,107,202,MM3_jia_DEGREE_TABLE.txt
1632,PRDM1,133,134,267,MM3_jia_DEGREE_TABLE.txt
1633,PRDM10,97,104,201,MM3_jia_DEGREE_TABLE.txt
1634,PRDM15,131,136,267,MM3_jia_DEGREE_TABLE.txt
1635,RARA,133,136,269,MM3_jia_DEGREE_TABLE.txt
1636,RELA,89,136,225,MM3_jia_DEGREE_TABLE.txt
1637,RERE,133,110,243,MM3_jia_DEGREE_TABLE.txt
1638,RFX1,114,135,249,MM3_jia_DEGREE_TABLE.txt
1639,RFX3,111,132,243,MM3_jia_DEGREE_TABLE.txt
1640,RREB1,132,136,268,MM3_jia_DEGREE_TABLE.txt
1641,RUNX1,128,124,252,MM3_jia_DEGREE_TABLE.txt
1642,RXRB,117,136,253,MM3_jia_DEGREE_TABLE.txt
1643,SF1,110,116,226,MM3_jia_DEGREE_TABLE.txt
1644,SIN3A,112,136,248,MM3_jia_DEGREE_TABLE.txt
1645,SMAD1,121,136,257,MM3_jia_DEGREE_TABLE.txt
1646,SMAD7,131,119,250,MM3_jia_DEGREE_TABLE.txt
1647,SNAI3,108,126,234,MM3_jia_DEGREE_TABLE.txt
1648,SOX15,125,136,261,MM3_jia_DEGREE_TABLE.txt
1649,SP3,98,135,233,MM3_jia_DEGREE_TABLE.txt
1650,SREBF2,120,126,246,MM3_jia_DEGREE_TABLE.txt
1651,TBX21,125,133,258,MM3_jia_DEGREE_TABLE.txt
1652,TBX6,112,117,229,MM3_jia_DEGREE_TABLE.txt
1653,TCF3,118,136,254,MM3_jia_DEGREE_TABLE.txt
1654,TEF,130,130,260,MM3_jia_DEGREE_TABLE.txt
1655,TFEB,133,93,226,MM3_jia_DEGREE_TABLE.txt
1656,TGIF2,120,123,243,MM3_jia_DEGREE_TABLE.txt
1657,THAP11,114,125,239,MM3_jia_DEGREE_TABLE.txt
1658,THRA,136,135,271,MM3_jia_DEGREE_TABLE.txt
1659,USF1,115,127,242,MM3_jia_DEGREE_TABLE.txt
1660,VDR,122,135,257,MM3_jia_DEGREE_TABLE.txt
1661,VSX1,127,121,248,MM3_jia_DEGREE_TABLE.txt
1662,XBP1,133,110,243,MM3_jia_DEGREE_TABLE.txt
1663,YY1,100,136,236,MM3_jia_DEGREE_TABLE.txt
1664,ZBTB20,119,109,228,MM3_jia_DEGREE_TABLE.txt
1665,ZBTB32,116,104,220,MM3_jia_DEGREE_TABLE.txt
1666,ZBTB38,133,123,256,MM3_jia_DEGREE_TABLE.txt
1667,ZBTB4,107,94,201,MM3_jia_DEGREE_TABLE.txt
1668,ZBTB7A,122,133,255,MM3_jia_DEGREE_TABLE.txt
1669,ZBTB7B,134,130,264,MM3_jia_DEGREE_TABLE.txt
1670,ZFP62,133,136,269,MM3_jia_DEGREE_TABLE.txt
1671,ZFP91,124,128,252,MM3_jia_DEGREE_TABLE.txt
1672,ZNF114,119,98,217,MM3_jia_DEGREE_TABLE.txt
1673,ZNF215,102,124,226,MM3_jia_DEGREE_TABLE.txt
1674,ZNF217,131,89,220,MM3_jia_DEGREE_TABLE.txt
1675,ZNF219,126,135,261,MM3_jia_DEGREE_TABLE.txt
1676,ZNF283,132,133,265,MM3_jia_DEGREE_TABLE.txt
1677,ZNF48,125,133,258,MM3_jia_DEGREE_TABLE.txt
1678,ZNF483,94,133,227,MM3_jia_DEGREE_TABLE.txt
1679,ZNF524,129,135,264,MM3_jia_DEGREE_TABLE.txt
1680,ZNF580,129,131,260,MM3_jia_DEGREE_TABLE.txt
1681,ZNF581,129,127,256,MM3_jia_DEGREE_TABLE.txt
1682,ZNF592,110,74,184,MM3_jia_DEGREE_TABLE.txt
1683,ZNF595,129,136,265,MM3_jia_DEGREE_TABLE.txt
1684,ZNF643,131,122,253,MM3_jia_DEGREE_TABLE.txt
1685,ZNF689,110,132,242,MM3_jia_DEGREE_TABLE.txt
1686,ZNF718,129,136,265,MM3_jia_DEGREE_TABLE.txt
1687,ZNF775,132,133,265,MM3_jia_DEGREE_TABLE.txt
1688,ZNF784,129,133,262,MM3_jia_DEGREE_TABLE.txt
1689,ARF1,78,39,117,MM5.H3K27ac_DEGREE_TABLE.txt
1690,ARID3A,96,80,176,MM5.H3K27ac_DEGREE_TABLE.txt
1691,ARID5A,89,83,172,MM5.H3K27ac_DEGREE_TABLE.txt
1692,ATF3,80,98,178,MM5.H3K27ac_DEGREE_TABLE.txt
1693,ATF4,96,93,189,MM5.H3K27ac_DEGREE_TABLE.txt
1694,BACH1,89,80,169,MM5.H3K27ac_DEGREE_TABLE.txt
1695,BHLHE40,92,82,174,MM5.H3K27ac_DEGREE_TABLE.txt
1696,BHLHE41,97,57,154,MM5.H3K27ac_DEGREE_TABLE.txt
1697,CEBPB,83,81,164,MM5.H3K27ac_DEGREE_TABLE.txt
1698,CEBPG,74,87,161,MM5.H3K27ac_DEGREE_TABLE.txt
1699,CHD2,93,95,188,MM5.H3K27ac_DEGREE_TABLE.txt
1700,CREB3L2,97,87,184,MM5.H3K27ac_DEGREE_TABLE.txt
1701,CTCFL,96,98,194,MM5.H3K27ac_DEGREE_TABLE.txt
1702,DDIT3,84,88,172,MM5.H3K27ac_DEGREE_TABLE.txt
1703,ELF2,66,80,146,MM5.H3K27ac_DEGREE_TABLE.txt
1704,ERF,75,78,153,MM5.H3K27ac_DEGREE_TABLE.txt
1705,ESRRG,81,94,175,MM5.H3K27ac_DEGREE_TABLE.txt
1706,ETS1,85,97,182,MM5.H3K27ac_DEGREE_TABLE.txt
1707,FLI1,98,96,194,MM5.H3K27ac_DEGREE_TABLE.txt
1708,FOS,76,89,165,MM5.H3K27ac_DEGREE_TABLE.txt
1709,FOXD4L5,62,84,146,MM5.H3K27ac_DEGREE_TABLE.txt
1710,FOXN3,85,75,160,MM5.H3K27ac_DEGREE_TABLE.txt
1711,FOXO1,87,98,185,MM5.H3K27ac_DEGREE_TABLE.txt
1712,FOXO3,97,98,195,MM5.H3K27ac_DEGREE_TABLE.txt
1713,FOXP2,81,93,174,MM5.H3K27ac_DEGREE_TABLE.txt
1714,HBP1,80,96,176,MM5.H3K27ac_DEGREE_TABLE.txt
1715,HES5,86,69,155,MM5.H3K27ac_DEGREE_TABLE.txt
1716,HINFP,88,90,178,MM5.H3K27ac_DEGREE_TABLE.txt
1717,IKZF1,96,95,191,MM5.H3K27ac_DEGREE_TABLE.txt
1718,IKZF3,97,98,195,MM5.H3K27ac_DEGREE_TABLE.txt
1719,IRF1,98,97,195,MM5.H3K27ac_DEGREE_TABLE.txt
1720,IRF2,98,82,180,MM5.H3K27ac_DEGREE_TABLE.txt
1721,IRF4,98,91,189,MM5.H3K27ac_DEGREE_TABLE.txt
1722,JUN,74,95,169,MM5.H3K27ac_DEGREE_TABLE.txt
1723,JUNB,98,89,187,MM5.H3K27ac_DEGREE_TABLE.txt
1724,JUND,76,98,174,MM5.H3K27ac_DEGREE_TABLE.txt
1725,KLF13,97,78,175,MM5.H3K27ac_DEGREE_TABLE.txt
1726,KLF15,76,98,174,MM5.H3K27ac_DEGREE_TABLE.txt
1727,KLF2,96,97,193,MM5.H3K27ac_DEGREE_TABLE.txt
1728,KLF3,93,96,189,MM5.H3K27ac_DEGREE_TABLE.txt
1729,KLF6,95,92,187,MM5.H3K27ac_DEGREE_TABLE.txt
1730,KLF7,81,98,179,MM5.H3K27ac_DEGREE_TABLE.txt
1731,KLF9,92,98,190,MM5.H3K27ac_DEGREE_TABLE.txt
1732,MEF2A,84,96,180,MM5.H3K27ac_DEGREE_TABLE.txt
1733,MEF2C,96,96,192,MM5.H3K27ac_DEGREE_TABLE.txt
1734,MEF2D,94,86,180,MM5.H3K27ac_DEGREE_TABLE.txt
1735,MXI1,82,84,166,MM5.H3K27ac_DEGREE_TABLE.txt
1736,MYBL2,87,65,152,MM5.H3K27ac_DEGREE_TABLE.txt
1737,MYC,82,80,162,MM5.H3K27ac_DEGREE_TABLE.txt
1738,MZF1,80,97,177,MM5.H3K27ac_DEGREE_TABLE.txt
1739,NFATC1,96,97,193,MM5.H3K27ac_DEGREE_TABLE.txt
1740,NFE2L1,71,76,147,MM5.H3K27ac_DEGREE_TABLE.txt
1741,NFE2L2,83,84,167,MM5.H3K27ac_DEGREE_TABLE.txt
1742,NFE2L3,89,97,186,MM5.H3K27ac_DEGREE_TABLE.txt
1743,NOBOX,90,62,152,MM5.H3K27ac_DEGREE_TABLE.txt
1744,NR1D1,96,95,191,MM5.H3K27ac_DEGREE_TABLE.txt
1745,NR3C1,73,93,166,MM5.H3K27ac_DEGREE_TABLE.txt
1746,NR4A2,91,96,187,MM5.H3K27ac_DEGREE_TABLE.txt
1747,PAX5,78,98,176,MM5.H3K27ac_DEGREE_TABLE.txt
1748,PBX2,87,72,159,MM5.H3K27ac_DEGREE_TABLE.txt
1749,POU5F1,85,94,179,MM5.H3K27ac_DEGREE_TABLE.txt
1750,POU5F1B,84,87,171,MM5.H3K27ac_DEGREE_TABLE.txt
1751,PRDM1,98,97,195,MM5.H3K27ac_DEGREE_TABLE.txt
1752,PRDM10,72,60,132,MM5.H3K27ac_DEGREE_TABLE.txt
1753,RARA,94,98,192,MM5.H3K27ac_DEGREE_TABLE.txt
1754,RERE,95,80,175,MM5.H3K27ac_DEGREE_TABLE.txt
1755,RFX1,85,96,181,MM5.H3K27ac_DEGREE_TABLE.txt
1756,RFX3,89,96,185,MM5.H3K27ac_DEGREE_TABLE.txt
1757,RUNX1,98,86,184,MM5.H3K27ac_DEGREE_TABLE.txt
1758,RXRB,81,98,179,MM5.H3K27ac_DEGREE_TABLE.txt
1759,SMAD7,95,86,181,MM5.H3K27ac_DEGREE_TABLE.txt
1760,SP3,68,98,166,MM5.H3K27ac_DEGREE_TABLE.txt
1761,TBX6,80,84,164,MM5.H3K27ac_DEGREE_TABLE.txt
1762,TCF3,91,98,189,MM5.H3K27ac_DEGREE_TABLE.txt
1763,THRA,96,93,189,MM5.H3K27ac_DEGREE_TABLE.txt
1764,USF2,85,91,176,MM5.H3K27ac_DEGREE_TABLE.txt
1765,XBP1,92,76,168,MM5.H3K27ac_DEGREE_TABLE.txt
1766,ZBTB1,92,74,166,MM5.H3K27ac_DEGREE_TABLE.txt
1767,ZBTB20,88,75,163,MM5.H3K27ac_DEGREE_TABLE.txt
1768,ZBTB32,88,66,154,MM5.H3K27ac_DEGREE_TABLE.txt
1769,ZBTB38,98,84,182,MM5.H3K27ac_DEGREE_TABLE.txt
1770,ZBTB42,75,76,151,MM5.H3K27ac_DEGREE_TABLE.txt
1771,ZBTB7A,93,93,186,MM5.H3K27ac_DEGREE_TABLE.txt
1772,ZBTB7B,89,94,183,MM5.H3K27ac_DEGREE_TABLE.txt
1773,ZFP62,93,98,191,MM5.H3K27ac_DEGREE_TABLE.txt
1774,ZFP91,91,84,175,MM5.H3K27ac_DEGREE_TABLE.txt
1775,ZNF114,88,64,152,MM5.H3K27ac_DEGREE_TABLE.txt
1776,ZNF217,90,57,147,MM5.H3K27ac_DEGREE_TABLE.txt
1777,ZNF283,85,94,179,MM5.H3K27ac_DEGREE_TABLE.txt
1778,ZNF460,95,98,193,MM5.H3K27ac_DEGREE_TABLE.txt
1779,ZNF48,80,93,173,MM5.H3K27ac_DEGREE_TABLE.txt
1780,ZNF526,75,97,172,MM5.H3K27ac_DEGREE_TABLE.txt
1781,ZNF543,95,98,193,MM5.H3K27ac_DEGREE_TABLE.txt
1782,ZNF643,97,89,186,MM5.H3K27ac_DEGREE_TABLE.txt
1783,ZNF771,80,74,154,MM5.H3K27ac_DEGREE_TABLE.txt
1784,ZNF775,86,94,180,MM5.H3K27ac_DEGREE_TABLE.txt
1785,ZNF805,95,94,189,MM5.H3K27ac_DEGREE_TABLE.txt
1786,ZNF860,97,98,195,MM5.H3K27ac_DEGREE_TABLE.txt
1787,ARF1,121,71,192,MM24.H3K27ac_DEGREE_TABLE.txt
1788,ARID3A,123,119,242,MM24.H3K27ac_DEGREE_TABLE.txt
1789,ARID3B,118,118,236,MM24.H3K27ac_DEGREE_TABLE.txt
1790,ARID5A,122,116,238,MM24.H3K27ac_DEGREE_TABLE.txt
1791,ATF4,125,124,249,MM24.H3K27ac_DEGREE_TABLE.txt
1792,ATF5,121,124,245,MM24.H3K27ac_DEGREE_TABLE.txt
1793,BACH1,119,119,238,MM24.H3K27ac_DEGREE_TABLE.txt
1794,BBX,106,121,227,MM24.H3K27ac_DEGREE_TABLE.txt
1795,BCL11A,122,125,247,MM24.H3K27ac_DEGREE_TABLE.txt
1796,BHLHE41,121,102,223,MM24.H3K27ac_DEGREE_TABLE.txt
1797,CHD2,125,125,250,MM24.H3K27ac_DEGREE_TABLE.txt
1798,CNOT3,104,122,226,MM24.H3K27ac_DEGREE_TABLE.txt
1799,CREB3L2,125,119,244,MM24.H3K27ac_DEGREE_TABLE.txt
1800,CREB3L4,124,112,236,MM24.H3K27ac_DEGREE_TABLE.txt
1801,CST6,122,67,189,MM24.H3K27ac_DEGREE_TABLE.txt
1802,CTCF,124,125,249,MM24.H3K27ac_DEGREE_TABLE.txt
1803,CUX1,120,120,240,MM24.H3K27ac_DEGREE_TABLE.txt
1804,DBP,121,125,246,MM24.H3K27ac_DEGREE_TABLE.txt
1805,DMRTC2,122,106,228,MM24.H3K27ac_DEGREE_TABLE.txt
1806,ELF1,122,125,247,MM24.H3K27ac_DEGREE_TABLE.txt
1807,ELK3,122,107,229,MM24.H3K27ac_DEGREE_TABLE.txt
1808,ERF,117,118,235,MM24.H3K27ac_DEGREE_TABLE.txt
1809,FIZ1,125,125,250,MM24.H3K27ac_DEGREE_TABLE.txt
1810,FLI1,125,125,250,MM24.H3K27ac_DEGREE_TABLE.txt
1811,FOSB,120,75,195,MM24.H3K27ac_DEGREE_TABLE.txt
1812,FOXO3,125,125,250,MM24.H3K27ac_DEGREE_TABLE.txt
1813,FOXP1,124,125,249,MM24.H3K27ac_DEGREE_TABLE.txt
1814,FOXP2,115,121,236,MM24.H3K27ac_DEGREE_TABLE.txt
1815,GABPA,114,125,239,MM24.H3K27ac_DEGREE_TABLE.txt
1816,HBP1,119,125,244,MM24.H3K27ac_DEGREE_TABLE.txt
1817,HES5,119,115,234,MM24.H3K27ac_DEGREE_TABLE.txt
1818,HEY2,119,112,231,MM24.H3K27ac_DEGREE_TABLE.txt
1819,HIVEP2,125,125,250,MM24.H3K27ac_DEGREE_TABLE.txt
1820,IKZF1,125,125,250,MM24.H3K27ac_DEGREE_TABLE.txt
1821,IKZF3,123,125,248,MM24.H3K27ac_DEGREE_TABLE.txt
1822,IRF1,125,125,250,MM24.H3K27ac_DEGREE_TABLE.txt
1823,IRF2,125,120,245,MM24.H3K27ac_DEGREE_TABLE.txt
1824,IRF4,125,125,250,MM24.H3K27ac_DEGREE_TABLE.txt
1825,IRF5,110,125,235,MM24.H3K27ac_DEGREE_TABLE.txt
1826,JUN,113,124,237,MM24.H3K27ac_DEGREE_TABLE.txt
1827,JUNB,123,123,246,MM24.H3K27ac_DEGREE_TABLE.txt
1828,JUND,120,125,245,MM24.H3K27ac_DEGREE_TABLE.txt
1829,KLF1,124,125,249,MM24.H3K27ac_DEGREE_TABLE.txt
1830,KLF10,121,125,246,MM24.H3K27ac_DEGREE_TABLE.txt
1831,KLF13,124,116,240,MM24.H3K27ac_DEGREE_TABLE.txt
1832,KLF16,120,125,245,MM24.H3K27ac_DEGREE_TABLE.txt
1833,KLF2,123,125,248,MM24.H3K27ac_DEGREE_TABLE.txt
1834,KLF3,117,125,242,MM24.H3K27ac_DEGREE_TABLE.txt
1835,KLF6,114,125,239,MM24.H3K27ac_DEGREE_TABLE.txt
1836,KLF9,124,125,249,MM24.H3K27ac_DEGREE_TABLE.txt
1837,MAZ,120,125,245,MM24.H3K27ac_DEGREE_TABLE.txt
1838,MEF2A,115,125,240,MM24.H3K27ac_DEGREE_TABLE.txt
1839,MEF2C,125,125,250,MM24.H3K27ac_DEGREE_TABLE.txt
1840,MEF2D,124,124,248,MM24.H3K27ac_DEGREE_TABLE.txt
1841,MEIS2,114,124,238,MM24.H3K27ac_DEGREE_TABLE.txt
1842,MXI1,122,124,246,MM24.H3K27ac_DEGREE_TABLE.txt
1843,MYC,116,120,236,MM24.H3K27ac_DEGREE_TABLE.txt
1844,MYNN,120,112,232,MM24.H3K27ac_DEGREE_TABLE.txt
1845,MZF1,114,125,239,MM24.H3K27ac_DEGREE_TABLE.txt
1846,NFATC1,113,125,238,MM24.H3K27ac_DEGREE_TABLE.txt
1847,NFE2L2,110,124,234,MM24.H3K27ac_DEGREE_TABLE.txt
1848,NFE2L3,125,125,250,MM24.H3K27ac_DEGREE_TABLE.txt
1849,NFIX,124,125,249,MM24.H3K27ac_DEGREE_TABLE.txt
1850,NFKB1,114,125,239,MM24.H3K27ac_DEGREE_TABLE.txt
1851,NFKB2,112,124,236,MM24.H3K27ac_DEGREE_TABLE.txt
1852,NOTCH1,119,120,239,MM24.H3K27ac_DEGREE_TABLE.txt
1853,NR1D1,124,125,249,MM24.H3K27ac_DEGREE_TABLE.txt
1854,NR1D2,122,117,239,MM24.H3K27ac_DEGREE_TABLE.txt
1855,NR1I3,124,105,229,MM24.H3K27ac_DEGREE_TABLE.txt
1856,NR3C1,118,123,241,MM24.H3K27ac_DEGREE_TABLE.txt
1857,NR4A1,123,122,245,MM24.H3K27ac_DEGREE_TABLE.txt
1858,NR4A2,121,125,246,MM24.H3K27ac_DEGREE_TABLE.txt
1859,NR4A3,114,109,223,MM24.H3K27ac_DEGREE_TABLE.txt
1860,PATZ1,118,125,243,MM24.H3K27ac_DEGREE_TABLE.txt
1861,PBX2,120,118,238,MM24.H3K27ac_DEGREE_TABLE.txt
1862,POU2F2,123,125,248,MM24.H3K27ac_DEGREE_TABLE.txt
1863,PPARD,124,123,247,MM24.H3K27ac_DEGREE_TABLE.txt
1864,PRDM1,123,125,248,MM24.H3K27ac_DEGREE_TABLE.txt
1865,PRDM15,125,125,250,MM24.H3K27ac_DEGREE_TABLE.txt
1866,RARA,122,125,247,MM24.H3K27ac_DEGREE_TABLE.txt
1867,RERE,118,114,232,MM24.H3K27ac_DEGREE_TABLE.txt
1868,RFX3,117,125,242,MM24.H3K27ac_DEGREE_TABLE.txt
1869,RFX7,113,100,213,MM24.H3K27ac_DEGREE_TABLE.txt
1870,RORA,122,125,247,MM24.H3K27ac_DEGREE_TABLE.txt
1871,RREB1,123,125,248,MM24.H3K27ac_DEGREE_TABLE.txt
1872,RUNX1,125,123,248,MM24.H3K27ac_DEGREE_TABLE.txt
1873,RUNX3,112,125,237,MM24.H3K27ac_DEGREE_TABLE.txt
1874,SMAD1,111,125,236,MM24.H3K27ac_DEGREE_TABLE.txt
1875,SMAD7,123,120,243,MM24.H3K27ac_DEGREE_TABLE.txt
1876,SP3,119,125,244,MM24.H3K27ac_DEGREE_TABLE.txt
1877,STAT6,125,125,250,MM24.H3K27ac_DEGREE_TABLE.txt
1878,TCF12,116,125,241,MM24.H3K27ac_DEGREE_TABLE.txt
1879,TCF3,111,125,236,MM24.H3K27ac_DEGREE_TABLE.txt
1880,TCF4,124,123,247,MM24.H3K27ac_DEGREE_TABLE.txt
1881,TCP1,113,121,234,MM24.H3K27ac_DEGREE_TABLE.txt
1882,THRA,124,124,248,MM24.H3K27ac_DEGREE_TABLE.txt
1883,XBP1,125,114,239,MM24.H3K27ac_DEGREE_TABLE.txt
1884,ZBTB1,121,114,235,MM24.H3K27ac_DEGREE_TABLE.txt
1885,ZBTB11,121,125,246,MM24.H3K27ac_DEGREE_TABLE.txt
1886,ZBTB20,118,114,232,MM24.H3K27ac_DEGREE_TABLE.txt
1887,ZBTB26,121,125,246,MM24.H3K27ac_DEGREE_TABLE.txt
1888,ZBTB38,125,120,245,MM24.H3K27ac_DEGREE_TABLE.txt
1889,ZBTB6,121,123,244,MM24.H3K27ac_DEGREE_TABLE.txt
1890,ZBTB7A,118,123,241,MM24.H3K27ac_DEGREE_TABLE.txt
1891,ZBTB7B,123,125,248,MM24.H3K27ac_DEGREE_TABLE.txt
1892,ZEB1,115,124,239,MM24.H3K27ac_DEGREE_TABLE.txt
1893,ZFP62,125,125,250,MM24.H3K27ac_DEGREE_TABLE.txt
1894,ZFP91,121,124,245,MM24.H3K27ac_DEGREE_TABLE.txt
1895,ZNF114,119,116,235,MM24.H3K27ac_DEGREE_TABLE.txt
1896,ZNF215,120,121,241,MM24.H3K27ac_DEGREE_TABLE.txt
1897,ZNF217,122,109,231,MM24.H3K27ac_DEGREE_TABLE.txt
1898,ZNF283,116,125,241,MM24.H3K27ac_DEGREE_TABLE.txt
1899,ZNF296,123,123,246,MM24.H3K27ac_DEGREE_TABLE.txt
1900,ZNF524,125,125,250,MM24.H3K27ac_DEGREE_TABLE.txt
1901,ZNF526,117,125,242,MM24.H3K27ac_DEGREE_TABLE.txt
1902,ZNF574,123,125,248,MM24.H3K27ac_DEGREE_TABLE.txt
1903,ZNF580,125,125,250,MM24.H3K27ac_DEGREE_TABLE.txt
1904,ZNF581,125,125,250,MM24.H3K27ac_DEGREE_TABLE.txt
1905,ZNF592,118,86,204,MM24.H3K27ac_DEGREE_TABLE.txt
1906,ZNF70,115,125,240,MM24.H3K27ac_DEGREE_TABLE.txt
1907,ZNF710,123,123,246,MM24.H3K27ac_DEGREE_TABLE.txt
1908,ZNF76,124,123,247,MM24.H3K27ac_DEGREE_TABLE.txt
1909,ZNF775,123,124,247,MM24.H3K27ac_DEGREE_TABLE.txt
1910,ZNF784,125,125,250,MM24.H3K27ac_DEGREE_TABLE.txt
1911,ZNF860,123,125,248,MM24.H3K27ac_DEGREE_TABLE.txt
1912,ARID5A,106,106,212,JJN3_H3K27ac_DEGREE_TABLE.txt
1913,ATF5,86,111,197,JJN3_H3K27ac_DEGREE_TABLE.txt
1914,BCL6B,105,113,218,JJN3_H3K27ac_DEGREE_TABLE.txt
1915,BHLHE22,111,100,211,JJN3_H3K27ac_DEGREE_TABLE.txt
1916,BHLHE40,110,96,206,JJN3_H3K27ac_DEGREE_TABLE.txt
1917,BHLHE41,110,71,181,JJN3_H3K27ac_DEGREE_TABLE.txt
1918,CAMTA1,101,45,146,JJN3_H3K27ac_DEGREE_TABLE.txt
1919,CAMTA2,108,29,137,JJN3_H3K27ac_DEGREE_TABLE.txt
1920,CEBPB,89,93,182,JJN3_H3K27ac_DEGREE_TABLE.txt
1921,CREB3L1,99,87,186,JJN3_H3K27ac_DEGREE_TABLE.txt
1922,CREB3L4,109,88,197,JJN3_H3K27ac_DEGREE_TABLE.txt
1923,CTCF,95,113,208,JJN3_H3K27ac_DEGREE_TABLE.txt
1924,DBP,101,103,204,JJN3_H3K27ac_DEGREE_TABLE.txt
1925,DDIT3,102,104,206,JJN3_H3K27ac_DEGREE_TABLE.txt
1926,E2F2,107,107,214,JJN3_H3K27ac_DEGREE_TABLE.txt
1927,E2F4,109,103,212,JJN3_H3K27ac_DEGREE_TABLE.txt
1928,ETV6,101,109,210,JJN3_H3K27ac_DEGREE_TABLE.txt
1929,FERD3L,111,103,214,JJN3_H3K27ac_DEGREE_TABLE.txt
1930,FIZ1,111,113,224,JJN3_H3K27ac_DEGREE_TABLE.txt
1931,FLI1,109,113,222,JJN3_H3K27ac_DEGREE_TABLE.txt
1932,FOSL1,112,91,203,JJN3_H3K27ac_DEGREE_TABLE.txt
1933,FOXH1,111,102,213,JJN3_H3K27ac_DEGREE_TABLE.txt
1934,FOXO3,105,113,218,JJN3_H3K27ac_DEGREE_TABLE.txt
1935,FOXP2,104,105,209,JJN3_H3K27ac_DEGREE_TABLE.txt
1936,GFI1,106,110,216,JJN3_H3K27ac_DEGREE_TABLE.txt
1937,GLI1,106,110,216,JJN3_H3K27ac_DEGREE_TABLE.txt
1938,GMEB2,80,75,155,JJN3_H3K27ac_DEGREE_TABLE.txt
1939,GZF1,110,71,181,JJN3_H3K27ac_DEGREE_TABLE.txt
1940,HINFP,108,110,218,JJN3_H3K27ac_DEGREE_TABLE.txt
1941,HSF4,109,85,194,JJN3_H3K27ac_DEGREE_TABLE.txt
1942,IRF2,105,95,200,JJN3_H3K27ac_DEGREE_TABLE.txt
1943,IRF3,105,111,216,JJN3_H3K27ac_DEGREE_TABLE.txt
1944,IRF4,108,108,216,JJN3_H3K27ac_DEGREE_TABLE.txt
1945,IRF5,100,106,206,JJN3_H3K27ac_DEGREE_TABLE.txt
1946,IRX2,110,99,209,JJN3_H3K27ac_DEGREE_TABLE.txt
1947,JUNB,109,107,216,JJN3_H3K27ac_DEGREE_TABLE.txt
1948,JUND,84,113,197,JJN3_H3K27ac_DEGREE_TABLE.txt
1949,KLF10,101,113,214,JJN3_H3K27ac_DEGREE_TABLE.txt
1950,KLF13,112,88,200,JJN3_H3K27ac_DEGREE_TABLE.txt
1951,KLF16,103,113,216,JJN3_H3K27ac_DEGREE_TABLE.txt
1952,KLF2,111,111,222,JJN3_H3K27ac_DEGREE_TABLE.txt
1953,KLF6,98,108,206,JJN3_H3K27ac_DEGREE_TABLE.txt
1954,KLF9,108,111,219,JJN3_H3K27ac_DEGREE_TABLE.txt
1955,MAF,101,112,213,JJN3_H3K27ac_DEGREE_TABLE.txt
1956,MAZ,112,113,225,JJN3_H3K27ac_DEGREE_TABLE.txt
1957,MEF2D,109,108,217,JJN3_H3K27ac_DEGREE_TABLE.txt
1958,MNX1,107,91,198,JJN3_H3K27ac_DEGREE_TABLE.txt
1959,MXI1,107,106,213,JJN3_H3K27ac_DEGREE_TABLE.txt
1960,MYC,113,98,211,JJN3_H3K27ac_DEGREE_TABLE.txt
1961,MZF1,95,111,206,JJN3_H3K27ac_DEGREE_TABLE.txt
1962,NFAT5,100,105,205,JJN3_H3K27ac_DEGREE_TABLE.txt
1963,NFE2L1,106,102,208,JJN3_H3K27ac_DEGREE_TABLE.txt
1964,NFE2L2,98,100,198,JJN3_H3K27ac_DEGREE_TABLE.txt
1965,NFE2L3,112,108,220,JJN3_H3K27ac_DEGREE_TABLE.txt
1966,NFIC,97,108,205,JJN3_H3K27ac_DEGREE_TABLE.txt
1967,NFKB2,104,107,211,JJN3_H3K27ac_DEGREE_TABLE.txt
1968,NR3C1,109,110,219,JJN3_H3K27ac_DEGREE_TABLE.txt
1969,POU2F1,93,113,206,JJN3_H3K27ac_DEGREE_TABLE.txt
1970,PRDM1,111,111,222,JJN3_H3K27ac_DEGREE_TABLE.txt
1971,PRDM10,88,87,175,JJN3_H3K27ac_DEGREE_TABLE.txt
1972,RAD21,103,113,216,JJN3_H3K27ac_DEGREE_TABLE.txt
1973,RARA,110,113,223,JJN3_H3K27ac_DEGREE_TABLE.txt
1974,RORA,112,113,225,JJN3_H3K27ac_DEGREE_TABLE.txt
1975,RUNX2,106,113,219,JJN3_H3K27ac_DEGREE_TABLE.txt
1976,RUNX3,109,112,221,JJN3_H3K27ac_DEGREE_TABLE.txt
1977,RXRB,97,111,208,JJN3_H3K27ac_DEGREE_TABLE.txt
1978,SMAD2,85,102,187,JJN3_H3K27ac_DEGREE_TABLE.txt
1979,SMAD7,113,92,205,JJN3_H3K27ac_DEGREE_TABLE.txt
1980,SP3,86,113,199,JJN3_H3K27ac_DEGREE_TABLE.txt
1981,SREBF1,101,105,206,JJN3_H3K27ac_DEGREE_TABLE.txt
1982,SREBF2,108,103,211,JJN3_H3K27ac_DEGREE_TABLE.txt
1983,STAT1,108,113,221,JJN3_H3K27ac_DEGREE_TABLE.txt
1984,TBX6,101,105,206,JJN3_H3K27ac_DEGREE_TABLE.txt
1985,TCF4,107,106,213,JJN3_H3K27ac_DEGREE_TABLE.txt
1986,TFAP2A,105,113,218,JJN3_H3K27ac_DEGREE_TABLE.txt
1987,TGIF1,104,103,207,JJN3_H3K27ac_DEGREE_TABLE.txt
1988,THAP1,106,113,219,JJN3_H3K27ac_DEGREE_TABLE.txt
1989,THAP11,102,94,196,JJN3_H3K27ac_DEGREE_TABLE.txt
1990,TWIST1,111,105,216,JJN3_H3K27ac_DEGREE_TABLE.txt
1991,USF2,76,112,188,JJN3_H3K27ac_DEGREE_TABLE.txt
1992,ZBTB1,100,79,179,JJN3_H3K27ac_DEGREE_TABLE.txt
1993,ZBTB3,97,111,208,JJN3_H3K27ac_DEGREE_TABLE.txt
1994,ZBTB32,105,85,190,JJN3_H3K27ac_DEGREE_TABLE.txt
1995,ZBTB38,110,99,209,JJN3_H3K27ac_DEGREE_TABLE.txt
1996,ZBTB7A,100,112,212,JJN3_H3K27ac_DEGREE_TABLE.txt
1997,ZBTB7B,111,105,216,JJN3_H3K27ac_DEGREE_TABLE.txt
1998,ZFP62,111,112,223,JJN3_H3K27ac_DEGREE_TABLE.txt
1999,ZFP91,107,109,216,JJN3_H3K27ac_DEGREE_TABLE.txt
2000,ZNF114,105,85,190,JJN3_H3K27ac_DEGREE_TABLE.txt
2001,ZNF131,87,103,190,JJN3_H3K27ac_DEGREE_TABLE.txt
2002,ZNF217,110,81,191,JJN3_H3K27ac_DEGREE_TABLE.txt
2003,ZNF22,109,102,211,JJN3_H3K27ac_DEGREE_TABLE.txt
2004,ZNF251,98,108,206,JJN3_H3K27ac_DEGREE_TABLE.txt
2005,ZNF267,99,113,212,JJN3_H3K27ac_DEGREE_TABLE.txt
2006,ZNF276,83,113,196,JJN3_H3K27ac_DEGREE_TABLE.txt
2007,ZNF335,86,109,195,JJN3_H3K27ac_DEGREE_TABLE.txt
2008,ZNF34,98,93,191,JJN3_H3K27ac_DEGREE_TABLE.txt
2009,ZNF497,97,111,208,JJN3_H3K27ac_DEGREE_TABLE.txt
2010,ZNF517,98,113,211,JJN3_H3K27ac_DEGREE_TABLE.txt
2011,ZNF524,111,110,221,JJN3_H3K27ac_DEGREE_TABLE.txt
2012,ZNF579,92,113,205,JJN3_H3K27ac_DEGREE_TABLE.txt
2013,ZNF580,111,111,222,JJN3_H3K27ac_DEGREE_TABLE.txt
2014,ZNF581,111,108,219,JJN3_H3K27ac_DEGREE_TABLE.txt
2015,ZNF584,97,95,192,JJN3_H3K27ac_DEGREE_TABLE.txt
2016,ZNF623,76,112,188,JJN3_H3K27ac_DEGREE_TABLE.txt
2017,ZNF688,100,85,185,JJN3_H3K27ac_DEGREE_TABLE.txt
2018,ZNF689,97,104,201,JJN3_H3K27ac_DEGREE_TABLE.txt
2019,ZNF764,100,85,185,JJN3_H3K27ac_DEGREE_TABLE.txt
2020,ZNF768,100,113,213,JJN3_H3K27ac_DEGREE_TABLE.txt
2021,ZNF775,106,107,213,JJN3_H3K27ac_DEGREE_TABLE.txt
2022,ZNF784,111,109,220,JJN3_H3K27ac_DEGREE_TABLE.txt
2023,ZNF785,82,85,167,JJN3_H3K27ac_DEGREE_TABLE.txt
2024,ZNF837,97,113,210,JJN3_H3K27ac_DEGREE_TABLE.txt
2025,ARF1,77,15,92,MM11.H3K27ac_DEGREE_TABLE.txt
2026,ARF4,75,34,109,MM11.H3K27ac_DEGREE_TABLE.txt
2027,ATF3,83,97,180,MM11.H3K27ac_DEGREE_TABLE.txt
2028,ATF4,72,86,158,MM11.H3K27ac_DEGREE_TABLE.txt
2029,ATF5,78,82,160,MM11.H3K27ac_DEGREE_TABLE.txt
2030,BACH1,79,57,136,MM11.H3K27ac_DEGREE_TABLE.txt
2031,BCLAF1,72,95,167,MM11.H3K27ac_DEGREE_TABLE.txt
2032,BHLHA15,67,58,125,MM11.H3K27ac_DEGREE_TABLE.txt
2033,BHLHE40,77,45,122,MM11.H3K27ac_DEGREE_TABLE.txt
2034,BHLHE41,86,33,119,MM11.H3K27ac_DEGREE_TABLE.txt
2035,BRCA1,74,18,92,MM11.H3K27ac_DEGREE_TABLE.txt
2036,CAMTA2,71,21,92,MM11.H3K27ac_DEGREE_TABLE.txt
2037,CEBPB,76,71,147,MM11.H3K27ac_DEGREE_TABLE.txt
2038,CEBPG,67,79,146,MM11.H3K27ac_DEGREE_TABLE.txt
2039,CHD2,88,83,171,MM11.H3K27ac_DEGREE_TABLE.txt
2040,CNOT3,55,79,134,MM11.H3K27ac_DEGREE_TABLE.txt
2041,CREB1,68,80,148,MM11.H3K27ac_DEGREE_TABLE.txt
2042,CREB3L2,79,65,144,MM11.H3K27ac_DEGREE_TABLE.txt
2043,CREM,67,66,133,MM11.H3K27ac_DEGREE_TABLE.txt
2044,DDIT3,79,66,145,MM11.H3K27ac_DEGREE_TABLE.txt
2045,ELF1,74,95,169,MM11.H3K27ac_DEGREE_TABLE.txt
2046,ELF2,58,71,129,MM11.H3K27ac_DEGREE_TABLE.txt
2047,ELK4,70,72,142,MM11.H3K27ac_DEGREE_TABLE.txt
2048,FOS,68,81,149,MM11.H3K27ac_DEGREE_TABLE.txt
2049,FOSB,87,35,122,MM11.H3K27ac_DEGREE_TABLE.txt
2050,FOSL2,79,65,144,MM11.H3K27ac_DEGREE_TABLE.txt
2051,FOXN2,73,84,157,MM11.H3K27ac_DEGREE_TABLE.txt
2052,FOXP2,72,77,149,MM11.H3K27ac_DEGREE_TABLE.txt
2053,GLI1,71,76,147,MM11.H3K27ac_DEGREE_TABLE.txt
2054,HAP1,73,6,79,MM11.H3K27ac_DEGREE_TABLE.txt
2055,HBP1,76,83,159,MM11.H3K27ac_DEGREE_TABLE.txt
2056,HIVEP2,83,72,155,MM11.H3K27ac_DEGREE_TABLE.txt
2057,IRF2,71,75,146,MM11.H3K27ac_DEGREE_TABLE.txt
2058,IRF4,84,86,170,MM11.H3K27ac_DEGREE_TABLE.txt
2059,IRF9,61,83,144,MM11.H3K27ac_DEGREE_TABLE.txt
2060,JUN,73,86,159,MM11.H3K27ac_DEGREE_TABLE.txt
2061,JUNB,85,80,165,MM11.H3K27ac_DEGREE_TABLE.txt
2062,JUND,70,94,164,MM11.H3K27ac_DEGREE_TABLE.txt
2063,KLF13,73,47,120,MM11.H3K27ac_DEGREE_TABLE.txt
2064,KLF2,82,88,170,MM11.H3K27ac_DEGREE_TABLE.txt
2065,KLF6,86,68,154,MM11.H3K27ac_DEGREE_TABLE.txt
2066,KLF7,70,97,167,MM11.H3K27ac_DEGREE_TABLE.txt
2067,KLF9,89,84,173,MM11.H3K27ac_DEGREE_TABLE.txt
2068,LHX6,66,67,133,MM11.H3K27ac_DEGREE_TABLE.txt
2069,MAFG,54,80,134,MM11.H3K27ac_DEGREE_TABLE.txt
2070,MEF2A,62,95,157,MM11.H3K27ac_DEGREE_TABLE.txt
2071,MEF2C,77,91,168,MM11.H3K27ac_DEGREE_TABLE.txt
2072,MNT,79,29,108,MM11.H3K27ac_DEGREE_TABLE.txt
2073,MXI1,82,76,158,MM11.H3K27ac_DEGREE_TABLE.txt
2074,MZF1,72,95,167,MM11.H3K27ac_DEGREE_TABLE.txt
2075,NFE2L2,82,68,150,MM11.H3K27ac_DEGREE_TABLE.txt
2076,NFE2L3,79,82,161,MM11.H3K27ac_DEGREE_TABLE.txt
2077,NFIL3,81,81,162,MM11.H3K27ac_DEGREE_TABLE.txt
2078,NFKB2,69,80,149,MM11.H3K27ac_DEGREE_TABLE.txt
2079,NFYA,75,60,135,MM11.H3K27ac_DEGREE_TABLE.txt
2080,NR1D1,86,81,167,MM11.H3K27ac_DEGREE_TABLE.txt
2081,NR1D2,75,49,124,MM11.H3K27ac_DEGREE_TABLE.txt
2082,NR3C1,89,79,168,MM11.H3K27ac_DEGREE_TABLE.txt
2083,NR4A2,79,89,168,MM11.H3K27ac_DEGREE_TABLE.txt
2084,NR4A3,78,62,140,MM11.H3K27ac_DEGREE_TABLE.txt
2085,NRL,67,54,121,MM11.H3K27ac_DEGREE_TABLE.txt
2086,PAX4,72,97,169,MM11.H3K27ac_DEGREE_TABLE.txt
2087,PLAGL2,74,97,171,MM11.H3K27ac_DEGREE_TABLE.txt
2088,POU2F1,73,97,170,MM11.H3K27ac_DEGREE_TABLE.txt
2089,PRDM1,85,93,178,MM11.H3K27ac_DEGREE_TABLE.txt
2090,PRDM10,62,42,104,MM11.H3K27ac_DEGREE_TABLE.txt
2091,PRDM5,65,96,161,MM11.H3K27ac_DEGREE_TABLE.txt
2092,RARA,69,96,165,MM11.H3K27ac_DEGREE_TABLE.txt
2093,RBPJ,74,75,149,MM11.H3K27ac_DEGREE_TABLE.txt
2094,RFX1,64,95,159,MM11.H3K27ac_DEGREE_TABLE.txt
2095,RFX3,74,84,158,MM11.H3K27ac_DEGREE_TABLE.txt
2096,RUNX1,65,63,128,MM11.H3K27ac_DEGREE_TABLE.txt
2097,RXRA,52,94,146,MM11.H3K27ac_DEGREE_TABLE.txt
2098,TBX6,72,62,134,MM11.H3K27ac_DEGREE_TABLE.txt
2099,THRA,86,84,170,MM11.H3K27ac_DEGREE_TABLE.txt
2100,TP53,73,78,151,MM11.H3K27ac_DEGREE_TABLE.txt
2101,USF1,77,65,142,MM11.H3K27ac_DEGREE_TABLE.txt
2102,VSX1,70,77,147,MM11.H3K27ac_DEGREE_TABLE.txt
2103,XBP1,85,56,141,MM11.H3K27ac_DEGREE_TABLE.txt
2104,YY1,58,97,155,MM11.H3K27ac_DEGREE_TABLE.txt
2105,ZBTB38,73,62,135,MM11.H3K27ac_DEGREE_TABLE.txt
2106,ZBTB7A,71,77,148,MM11.H3K27ac_DEGREE_TABLE.txt
2107,ZBTB7B,93,82,175,MM11.H3K27ac_DEGREE_TABLE.txt
2108,ZFP91,81,71,152,MM11.H3K27ac_DEGREE_TABLE.txt
2109,ZFX,60,96,156,MM11.H3K27ac_DEGREE_TABLE.txt
2110,ZNF165,78,69,147,MM11.H3K27ac_DEGREE_TABLE.txt
2111,ZNF189,60,93,153,MM11.H3K27ac_DEGREE_TABLE.txt
2112,ZNF460,66,95,161,MM11.H3K27ac_DEGREE_TABLE.txt
2113,ZNF483,66,83,149,MM11.H3K27ac_DEGREE_TABLE.txt
2114,ZNF543,66,95,161,MM11.H3K27ac_DEGREE_TABLE.txt
2115,ZNF672,77,91,168,MM11.H3K27ac_DEGREE_TABLE.txt
2116,ZNF687,69,38,107,MM11.H3K27ac_DEGREE_TABLE.txt
2117,ZNF692,77,80,157,MM11.H3K27ac_DEGREE_TABLE.txt
2118,ZNF775,67,87,154,MM11.H3K27ac_DEGREE_TABLE.txt
2119,ZNF79,67,84,151,MM11.H3K27ac_DEGREE_TABLE.txt
2120,ZNF805,66,85,151,MM11.H3K27ac_DEGREE_TABLE.txt
2121,ZSCAN16,78,46,124,MM11.H3K27ac_DEGREE_TABLE.txt
2122,AIRE,90,92,182,RPMI8226_H3K27ac_DEGREE_TABLE.txt
2123,ARF1,86,43,129,RPMI8226_H3K27ac_DEGREE_TABLE.txt
2124,ARID3A,94,87,181,RPMI8226_H3K27ac_DEGREE_TABLE.txt
2125,ARID5A,93,90,183,RPMI8226_H3K27ac_DEGREE_TABLE.txt
2126,ATF4,93,92,185,RPMI8226_H3K27ac_DEGREE_TABLE.txt
2127,BCL6B,90,96,186,RPMI8226_H3K27ac_DEGREE_TABLE.txt
2128,BHLHE40,92,82,174,RPMI8226_H3K27ac_DEGREE_TABLE.txt
2129,CAMTA2,94,24,118,RPMI8226_H3K27ac_DEGREE_TABLE.txt
2130,CREB3L4,93,75,168,RPMI8226_H3K27ac_DEGREE_TABLE.txt
2131,CTCF,88,96,184,RPMI8226_H3K27ac_DEGREE_TABLE.txt
2132,CUX1,87,84,171,RPMI8226_H3K27ac_DEGREE_TABLE.txt
2133,DUX4,64,84,148,RPMI8226_H3K27ac_DEGREE_TABLE.txt
2134,E2F2,93,94,187,RPMI8226_H3K27ac_DEGREE_TABLE.txt
2135,E2F3,87,96,183,RPMI8226_H3K27ac_DEGREE_TABLE.txt
2136,E2F4,95,89,184,RPMI8226_H3K27ac_DEGREE_TABLE.txt
2137,ESRRA,70,96,166,RPMI8226_H3K27ac_DEGREE_TABLE.txt
2138,ETV6,94,94,188,RPMI8226_H3K27ac_DEGREE_TABLE.txt
2139,FIZ1,92,96,188,RPMI8226_H3K27ac_DEGREE_TABLE.txt
2140,FOSL1,89,88,177,RPMI8226_H3K27ac_DEGREE_TABLE.txt
2141,FOXH1,80,83,163,RPMI8226_H3K27ac_DEGREE_TABLE.txt
2142,FOXO3,89,95,184,RPMI8226_H3K27ac_DEGREE_TABLE.txt
2143,FOXR1,88,94,182,RPMI8226_H3K27ac_DEGREE_TABLE.txt
2144,GLI1,90,94,184,RPMI8226_H3K27ac_DEGREE_TABLE.txt
2145,HES1,89,95,184,RPMI8226_H3K27ac_DEGREE_TABLE.txt
2146,HNF1B,87,86,173,RPMI8226_H3K27ac_DEGREE_TABLE.txt
2147,HSF4,95,77,172,RPMI8226_H3K27ac_DEGREE_TABLE.txt
2148,IRF1,94,95,189,RPMI8226_H3K27ac_DEGREE_TABLE.txt
2149,IRF2,94,86,180,RPMI8226_H3K27ac_DEGREE_TABLE.txt
2150,IRF4,92,96,188,RPMI8226_H3K27ac_DEGREE_TABLE.txt
2151,IRF5,91,96,187,RPMI8226_H3K27ac_DEGREE_TABLE.txt
2152,JUNB,93,89,182,RPMI8226_H3K27ac_DEGREE_TABLE.txt
2153,KLF13,95,77,172,RPMI8226_H3K27ac_DEGREE_TABLE.txt
2154,KLF16,88,95,183,RPMI8226_H3K27ac_DEGREE_TABLE.txt
2155,KLF3,92,94,186,RPMI8226_H3K27ac_DEGREE_TABLE.txt
2156,KLF6,84,86,170,RPMI8226_H3K27ac_DEGREE_TABLE.txt
2157,KLF9,92,96,188,RPMI8226_H3K27ac_DEGREE_TABLE.txt
2158,LTF,92,79,171,RPMI8226_H3K27ac_DEGREE_TABLE.txt
2159,MAF,95,96,191,RPMI8226_H3K27ac_DEGREE_TABLE.txt
2160,MAFG,88,96,184,RPMI8226_H3K27ac_DEGREE_TABLE.txt
2161,MAZ,94,96,190,RPMI8226_H3K27ac_DEGREE_TABLE.txt
2162,MEF2D,94,95,189,RPMI8226_H3K27ac_DEGREE_TABLE.txt
2163,MNX1,93,82,175,RPMI8226_H3K27ac_DEGREE_TABLE.txt
2164,MYC,90,89,179,RPMI8226_H3K27ac_DEGREE_TABLE.txt
2165,MZF1,85,96,181,RPMI8226_H3K27ac_DEGREE_TABLE.txt
2166,NFAT5,87,95,182,RPMI8226_H3K27ac_DEGREE_TABLE.txt
2167,NFE2L1,92,84,176,RPMI8226_H3K27ac_DEGREE_TABLE.txt
2168,NFE2L2,82,86,168,RPMI8226_H3K27ac_DEGREE_TABLE.txt
2169,NFE2L3,94,92,186,RPMI8226_H3K27ac_DEGREE_TABLE.txt
2170,NFIC,88,94,182,RPMI8226_H3K27ac_DEGREE_TABLE.txt
2171,NFKB2,88,95,183,RPMI8226_H3K27ac_DEGREE_TABLE.txt
2172,NOTCH1,90,85,175,RPMI8226_H3K27ac_DEGREE_TABLE.txt
2173,NR1D1,93,95,188,RPMI8226_H3K27ac_DEGREE_TABLE.txt
2174,NR3C1,92,93,185,RPMI8226_H3K27ac_DEGREE_TABLE.txt
2175,NR4A2,90,95,185,RPMI8226_H3K27ac_DEGREE_TABLE.txt
2176,POU2F1,84,95,179,RPMI8226_H3K27ac_DEGREE_TABLE.txt
2177,PRDM1,95,95,190,RPMI8226_H3K27ac_DEGREE_TABLE.txt
2178,RARA,95,96,191,RPMI8226_H3K27ac_DEGREE_TABLE.txt
2179,RARG,93,96,189,RPMI8226_H3K27ac_DEGREE_TABLE.txt
2180,RUNX3,87,96,183,RPMI8226_H3K27ac_DEGREE_TABLE.txt
2181,RXRA,91,96,187,RPMI8226_H3K27ac_DEGREE_TABLE.txt
2182,RXRB,87,95,182,RPMI8226_H3K27ac_DEGREE_TABLE.txt
2183,SMAD3,95,96,191,RPMI8226_H3K27ac_DEGREE_TABLE.txt
2184,SMAD7,95,85,180,RPMI8226_H3K27ac_DEGREE_TABLE.txt
2185,SP3,75,96,171,RPMI8226_H3K27ac_DEGREE_TABLE.txt
2186,SREBF1,95,91,186,RPMI8226_H3K27ac_DEGREE_TABLE.txt
2187,SREBF2,93,89,182,RPMI8226_H3K27ac_DEGREE_TABLE.txt
2188,TBX6,79,91,170,RPMI8226_H3K27ac_DEGREE_TABLE.txt
2189,TCF4,89,94,183,RPMI8226_H3K27ac_DEGREE_TABLE.txt
2190,THAP11,86,91,177,RPMI8226_H3K27ac_DEGREE_TABLE.txt
2191,THRA,93,94,187,RPMI8226_H3K27ac_DEGREE_TABLE.txt
2192,XBP1,89,72,161,RPMI8226_H3K27ac_DEGREE_TABLE.txt
2193,ZBTB3,85,95,180,RPMI8226_H3K27ac_DEGREE_TABLE.txt
2194,ZBTB38,93,93,186,RPMI8226_H3K27ac_DEGREE_TABLE.txt
2195,ZBTB7A,82,94,176,RPMI8226_H3K27ac_DEGREE_TABLE.txt
2196,ZBTB7B,95,91,186,RPMI8226_H3K27ac_DEGREE_TABLE.txt
2197,ZFP62,95,95,190,RPMI8226_H3K27ac_DEGREE_TABLE.txt
2198,ZFP91,89,92,181,RPMI8226_H3K27ac_DEGREE_TABLE.txt
2199,ZNF114,90,72,162,RPMI8226_H3K27ac_DEGREE_TABLE.txt
2200,ZNF131,73,95,168,RPMI8226_H3K27ac_DEGREE_TABLE.txt
2201,ZNF217,93,75,168,RPMI8226_H3K27ac_DEGREE_TABLE.txt
2202,ZNF267,92,96,188,RPMI8226_H3K27ac_DEGREE_TABLE.txt
2203,ZNF283,80,96,176,RPMI8226_H3K27ac_DEGREE_TABLE.txt
2204,ZNF497,89,93,182,RPMI8226_H3K27ac_DEGREE_TABLE.txt
2205,ZNF524,92,96,188,RPMI8226_H3K27ac_DEGREE_TABLE.txt
2206,ZNF580,92,94,186,RPMI8226_H3K27ac_DEGREE_TABLE.txt
2207,ZNF581,92,95,187,RPMI8226_H3K27ac_DEGREE_TABLE.txt
2208,ZNF584,89,90,179,RPMI8226_H3K27ac_DEGREE_TABLE.txt
2209,ZNF688,91,75,166,RPMI8226_H3K27ac_DEGREE_TABLE.txt
2210,ZNF689,84,92,176,RPMI8226_H3K27ac_DEGREE_TABLE.txt
2211,ZNF740,93,96,189,RPMI8226_H3K27ac_DEGREE_TABLE.txt
2212,ZNF764,91,78,169,RPMI8226_H3K27ac_DEGREE_TABLE.txt
2213,ZNF768,91,96,187,RPMI8226_H3K27ac_DEGREE_TABLE.txt
2214,ZNF775,94,93,187,RPMI8226_H3K27ac_DEGREE_TABLE.txt
2215,ZNF784,92,95,187,RPMI8226_H3K27ac_DEGREE_TABLE.txt
2216,ZNF785,91,76,167,RPMI8226_H3K27ac_DEGREE_TABLE.txt
2217,ZNF837,89,96,185,RPMI8226_H3K27ac_DEGREE_TABLE.txt
2218,ATF3,70,85,155,U266.H3K27ac_DEGREE_TABLE.txt
2219,ATF4,72,77,149,U266.H3K27ac_DEGREE_TABLE.txt
2220,ATF5,85,80,165,U266.H3K27ac_DEGREE_TABLE.txt
2221,BACH2,73,75,148,U266.H3K27ac_DEGREE_TABLE.txt
2222,BHLHE40,84,59,143,U266.H3K27ac_DEGREE_TABLE.txt
2223,BHLHE41,81,49,130,U266.H3K27ac_DEGREE_TABLE.txt
2224,CHD2,82,80,162,U266.H3K27ac_DEGREE_TABLE.txt
2225,CUX1,72,68,140,U266.H3K27ac_DEGREE_TABLE.txt
2226,DDIT3,76,79,155,U266.H3K27ac_DEGREE_TABLE.txt
2227,E2F2,83,80,163,U266.H3K27ac_DEGREE_TABLE.txt
2228,E2F6,73,83,156,U266.H3K27ac_DEGREE_TABLE.txt
2229,ELF2,66,70,136,U266.H3K27ac_DEGREE_TABLE.txt
2230,ELK3,76,57,133,U266.H3K27ac_DEGREE_TABLE.txt
2231,ERF,70,67,137,U266.H3K27ac_DEGREE_TABLE.txt
2232,FOS,70,75,145,U266.H3K27ac_DEGREE_TABLE.txt
2233,FOSL1,72,57,129,U266.H3K27ac_DEGREE_TABLE.txt
2234,FOSL2,73,70,143,U266.H3K27ac_DEGREE_TABLE.txt
2235,FOXK2,78,65,143,U266.H3K27ac_DEGREE_TABLE.txt
2236,FOXN3,82,25,107,U266.H3K27ac_DEGREE_TABLE.txt
2237,FOXO3,78,84,162,U266.H3K27ac_DEGREE_TABLE.txt
2238,FOXP1,78,84,162,U266.H3K27ac_DEGREE_TABLE.txt
2239,HBP1,66,81,147,U266.H3K27ac_DEGREE_TABLE.txt
2240,HES1,81,81,162,U266.H3K27ac_DEGREE_TABLE.txt
2241,HIVEP2,76,76,152,U266.H3K27ac_DEGREE_TABLE.txt
2242,IKZF3,81,85,166,U266.H3K27ac_DEGREE_TABLE.txt
2243,IRF2,82,69,151,U266.H3K27ac_DEGREE_TABLE.txt
2244,JUNB,79,79,158,U266.H3K27ac_DEGREE_TABLE.txt
2245,JUND,68,84,152,U266.H3K27ac_DEGREE_TABLE.txt
2246,KLF2,85,81,166,U266.H3K27ac_DEGREE_TABLE.txt
2247,KLF6,85,76,161,U266.H3K27ac_DEGREE_TABLE.txt
2248,LHX3,72,72,144,U266.H3K27ac_DEGREE_TABLE.txt
2249,LHX6,63,72,135,U266.H3K27ac_DEGREE_TABLE.txt
2250,MAFF,81,85,166,U266.H3K27ac_DEGREE_TABLE.txt
2251,MEF2D,83,78,161,U266.H3K27ac_DEGREE_TABLE.txt
2252,MYBL2,78,61,139,U266.H3K27ac_DEGREE_TABLE.txt
2253,MYNN,59,61,120,U266.H3K27ac_DEGREE_TABLE.txt
2254,NFE2,59,58,117,U266.H3K27ac_DEGREE_TABLE.txt
2255,NFE2L1,72,69,141,U266.H3K27ac_DEGREE_TABLE.txt
2256,NFE2L2,73,72,145,U266.H3K27ac_DEGREE_TABLE.txt
2257,NFE2L3,84,84,168,U266.H3K27ac_DEGREE_TABLE.txt
2258,NFKB2,65,82,147,U266.H3K27ac_DEGREE_TABLE.txt
2259,NR1D1,83,85,168,U266.H3K27ac_DEGREE_TABLE.txt
2260,NR1D2,74,69,143,U266.H3K27ac_DEGREE_TABLE.txt
2261,NR4A2,76,82,158,U266.H3K27ac_DEGREE_TABLE.txt
2262,NR4A3,74,55,129,U266.H3K27ac_DEGREE_TABLE.txt
2263,POU2F1,69,85,154,U266.H3K27ac_DEGREE_TABLE.txt
2264,POU2F2,75,85,160,U266.H3K27ac_DEGREE_TABLE.txt
2265,PRDM1,84,85,169,U266.H3K27ac_DEGREE_TABLE.txt
2266,PRDM5,66,84,150,U266.H3K27ac_DEGREE_TABLE.txt
2267,RFX3,73,80,153,U266.H3K27ac_DEGREE_TABLE.txt
2268,RORA,85,83,168,U266.H3K27ac_DEGREE_TABLE.txt
2269,RUNX1,84,78,162,U266.H3K27ac_DEGREE_TABLE.txt
2270,RUNX2,77,82,159,U266.H3K27ac_DEGREE_TABLE.txt
2271,SIN3A,73,85,158,U266.H3K27ac_DEGREE_TABLE.txt
2272,SMAD3,69,85,154,U266.H3K27ac_DEGREE_TABLE.txt
2273,SMAD7,78,70,148,U266.H3K27ac_DEGREE_TABLE.txt
2274,SOX11,74,85,159,U266.H3K27ac_DEGREE_TABLE.txt
2275,SP3,63,85,148,U266.H3K27ac_DEGREE_TABLE.txt
2276,SREBF2,69,76,145,U266.H3K27ac_DEGREE_TABLE.txt
2277,STAT2,80,83,163,U266.H3K27ac_DEGREE_TABLE.txt
2278,TBX6,69,75,144,U266.H3K27ac_DEGREE_TABLE.txt
2279,TCF3,72,85,157,U266.H3K27ac_DEGREE_TABLE.txt
2280,THRA,83,84,167,U266.H3K27ac_DEGREE_TABLE.txt
2281,VEZF1,66,70,136,U266.H3K27ac_DEGREE_TABLE.txt
2282,XBP1,84,54,138,U266.H3K27ac_DEGREE_TABLE.txt
2283,ZBTB38,85,72,157,U266.H3K27ac_DEGREE_TABLE.txt
2284,ZBTB7B,83,79,162,U266.H3K27ac_DEGREE_TABLE.txt
2285,ZFP1,76,83,159,U266.H3K27ac_DEGREE_TABLE.txt
2286,ZFP62,67,85,152,U266.H3K27ac_DEGREE_TABLE.txt
2287,ZFP91,78,73,151,U266.H3K27ac_DEGREE_TABLE.txt
2288,ZNF124,78,79,157,U266.H3K27ac_DEGREE_TABLE.txt
2289,ZNF217,84,53,137,U266.H3K27ac_DEGREE_TABLE.txt
2290,ZNF331,83,84,167,U266.H3K27ac_DEGREE_TABLE.txt
2291,ZNF334,76,79,155,U266.H3K27ac_DEGREE_TABLE.txt
2292,ZNF460,75,85,160,U266.H3K27ac_DEGREE_TABLE.txt
2293,ZNF490,74,73,147,U266.H3K27ac_DEGREE_TABLE.txt
2294,ZNF526,70,85,155,U266.H3K27ac_DEGREE_TABLE.txt
2295,ZNF543,75,83,158,U266.H3K27ac_DEGREE_TABLE.txt
2296,ZNF554,70,62,132,U266.H3K27ac_DEGREE_TABLE.txt
2297,ZNF574,75,83,158,U266.H3K27ac_DEGREE_TABLE.txt
2298,ZNF69,69,80,149,U266.H3K27ac_DEGREE_TABLE.txt
2299,ZNF700,69,82,151,U266.H3K27ac_DEGREE_TABLE.txt
2300,ZNF763,69,53,122,U266.H3K27ac_DEGREE_TABLE.txt
2301,ZNF791,74,70,144,U266.H3K27ac_DEGREE_TABLE.txt
2302,ZNF805,75,83,158,U266.H3K27ac_DEGREE_TABLE.txt
2303,ARID3A,103,112,215,MM2_jia_DEGREE_TABLE.txt
2304,ARID3B,110,109,219,MM2_jia_DEGREE_TABLE.txt
2305,ARID5A,114,116,230,MM2_jia_DEGREE_TABLE.txt
2306,ATF4,121,121,242,MM2_jia_DEGREE_TABLE.txt
2307,ATF5,123,122,245,MM2_jia_DEGREE_TABLE.txt
2308,BARX2,124,102,226,MM2_jia_DEGREE_TABLE.txt
2309,BCL6B,113,124,237,MM2_jia_DEGREE_TABLE.txt
2310,BCLAF1,99,124,223,MM2_jia_DEGREE_TABLE.txt
2311,BHLHE41,120,81,201,MM2_jia_DEGREE_TABLE.txt
2312,CAMTA2,111,34,145,MM2_jia_DEGREE_TABLE.txt
2313,CHD2,113,122,235,MM2_jia_DEGREE_TABLE.txt
2314,CREB1,111,120,231,MM2_jia_DEGREE_TABLE.txt
2315,CREB3L2,121,115,236,MM2_jia_DEGREE_TABLE.txt
2316,DMRTC2,119,83,202,MM2_jia_DEGREE_TABLE.txt
2317,E2F3,116,123,239,MM2_jia_DEGREE_TABLE.txt
2318,ELK3,119,97,216,MM2_jia_DEGREE_TABLE.txt
2319,ERF,111,115,226,MM2_jia_DEGREE_TABLE.txt
2320,ESRRA,114,124,238,MM2_jia_DEGREE_TABLE.txt
2321,FIZ1,114,123,237,MM2_jia_DEGREE_TABLE.txt
2322,FLI1,124,124,248,MM2_jia_DEGREE_TABLE.txt
2323,FOSB,114,67,181,MM2_jia_DEGREE_TABLE.txt
2324,FOSL1,119,101,220,MM2_jia_DEGREE_TABLE.txt
2325,FOXO3,120,123,243,MM2_jia_DEGREE_TABLE.txt
2326,GZF1,114,63,177,MM2_jia_DEGREE_TABLE.txt
2327,HAP1,99,21,120,MM2_jia_DEGREE_TABLE.txt
2328,HES1,111,121,232,MM2_jia_DEGREE_TABLE.txt
2329,HES5,113,93,206,MM2_jia_DEGREE_TABLE.txt
2330,HES7,116,122,238,MM2_jia_DEGREE_TABLE.txt
2331,HINFP,112,117,229,MM2_jia_DEGREE_TABLE.txt
2332,HIVEP2,120,121,241,MM2_jia_DEGREE_TABLE.txt
2333,IKZF1,118,122,240,MM2_jia_DEGREE_TABLE.txt
2334,IKZF3,123,124,247,MM2_jia_DEGREE_TABLE.txt
2335,IRF1,123,124,247,MM2_jia_DEGREE_TABLE.txt
2336,IRF2,114,105,219,MM2_jia_DEGREE_TABLE.txt
2337,IRF3,116,123,239,MM2_jia_DEGREE_TABLE.txt
2338,IRF4,121,115,236,MM2_jia_DEGREE_TABLE.txt
2339,JUNB,122,116,238,MM2_jia_DEGREE_TABLE.txt
2340,JUND,102,124,226,MM2_jia_DEGREE_TABLE.txt
2341,KLF1,119,124,243,MM2_jia_DEGREE_TABLE.txt
2342,KLF12,118,124,242,MM2_jia_DEGREE_TABLE.txt
2343,KLF13,123,105,228,MM2_jia_DEGREE_TABLE.txt
2344,KLF16,108,122,230,MM2_jia_DEGREE_TABLE.txt
2345,KLF2,114,123,237,MM2_jia_DEGREE_TABLE.txt
2346,KLF3,114,123,237,MM2_jia_DEGREE_TABLE.txt
2347,KLF6,103,120,223,MM2_jia_DEGREE_TABLE.txt
2348,LHX6,107,110,217,MM2_jia_DEGREE_TABLE.txt
2349,MAZ,117,124,241,MM2_jia_DEGREE_TABLE.txt
2350,MEF2C,123,121,244,MM2_jia_DEGREE_TABLE.txt
2351,MEF2D,120,122,242,MM2_jia_DEGREE_TABLE.txt
2352,MNT,108,80,188,MM2_jia_DEGREE_TABLE.txt
2353,MZF1,116,123,239,MM2_jia_DEGREE_TABLE.txt
2354,NFE2L2,114,103,217,MM2_jia_DEGREE_TABLE.txt
2355,NFE2L3,114,123,237,MM2_jia_DEGREE_TABLE.txt
2356,NFIX,119,121,240,MM2_jia_DEGREE_TABLE.txt
2357,NFKB1,97,123,220,MM2_jia_DEGREE_TABLE.txt
2358,NFKB2,108,120,228,MM2_jia_DEGREE_TABLE.txt
2359,NR1D1,119,122,241,MM2_jia_DEGREE_TABLE.txt
2360,NR3C1,122,118,240,MM2_jia_DEGREE_TABLE.txt
2361,NR4A2,114,124,238,MM2_jia_DEGREE_TABLE.txt
2362,NR4A3,93,87,180,MM2_jia_DEGREE_TABLE.txt
2363,OVOL1,108,102,210,MM2_jia_DEGREE_TABLE.txt
2364,PAX5,116,124,240,MM2_jia_DEGREE_TABLE.txt
2365,PBX2,110,101,211,MM2_jia_DEGREE_TABLE.txt
2366,POU2F2,122,124,246,MM2_jia_DEGREE_TABLE.txt
2367,POU5F1,113,123,236,MM2_jia_DEGREE_TABLE.txt
2368,PRDM1,124,122,246,MM2_jia_DEGREE_TABLE.txt
2369,PRDM10,89,97,186,MM2_jia_DEGREE_TABLE.txt
2370,RARA,102,124,226,MM2_jia_DEGREE_TABLE.txt
2371,RAX2,94,71,165,MM2_jia_DEGREE_TABLE.txt
2372,RELA,113,124,237,MM2_jia_DEGREE_TABLE.txt
2373,RELB,115,112,227,MM2_jia_DEGREE_TABLE.txt
2374,RFX1,90,124,214,MM2_jia_DEGREE_TABLE.txt
2375,RFX3,107,121,228,MM2_jia_DEGREE_TABLE.txt
2376,SF1,109,112,221,MM2_jia_DEGREE_TABLE.txt
2377,SIN3A,109,124,233,MM2_jia_DEGREE_TABLE.txt
2378,SIX5,108,124,232,MM2_jia_DEGREE_TABLE.txt
2379,SMAD7,123,112,235,MM2_jia_DEGREE_TABLE.txt
2380,SOX15,106,123,229,MM2_jia_DEGREE_TABLE.txt
2381,TBX6,103,115,218,MM2_jia_DEGREE_TABLE.txt
2382,TCF3,108,124,232,MM2_jia_DEGREE_TABLE.txt
2383,TCF4,113,120,233,MM2_jia_DEGREE_TABLE.txt
2384,TFEB,116,93,209,MM2_jia_DEGREE_TABLE.txt
2385,TGIF2,98,107,205,MM2_jia_DEGREE_TABLE.txt
2386,THRA,119,122,241,MM2_jia_DEGREE_TABLE.txt
2387,USF1,104,120,224,MM2_jia_DEGREE_TABLE.txt
2388,XBP1,122,105,227,MM2_jia_DEGREE_TABLE.txt
2389,ZBTB1,115,98,213,MM2_jia_DEGREE_TABLE.txt
2390,ZBTB32,106,100,206,MM2_jia_DEGREE_TABLE.txt
2391,ZBTB38,123,111,234,MM2_jia_DEGREE_TABLE.txt
2392,ZBTB5,90,122,212,MM2_jia_DEGREE_TABLE.txt
2393,ZBTB7A,109,122,231,MM2_jia_DEGREE_TABLE.txt
2394,ZFP62,122,124,246,MM2_jia_DEGREE_TABLE.txt
2395,ZFP91,115,116,231,MM2_jia_DEGREE_TABLE.txt
2396,ZNF114,121,96,217,MM2_jia_DEGREE_TABLE.txt
2397,ZNF143,101,116,217,MM2_jia_DEGREE_TABLE.txt
2398,ZNF215,119,115,234,MM2_jia_DEGREE_TABLE.txt
2399,ZNF217,119,80,199,MM2_jia_DEGREE_TABLE.txt
2400,ZNF283,121,123,244,MM2_jia_DEGREE_TABLE.txt
2401,ZNF335,102,114,216,MM2_jia_DEGREE_TABLE.txt
2402,ZNF367,105,98,203,MM2_jia_DEGREE_TABLE.txt
2403,ZNF460,108,124,232,MM2_jia_DEGREE_TABLE.txt
2404,ZNF48,105,116,221,MM2_jia_DEGREE_TABLE.txt
2405,ZNF490,104,109,213,MM2_jia_DEGREE_TABLE.txt
2406,ZNF524,114,124,238,MM2_jia_DEGREE_TABLE.txt
2407,ZNF526,93,123,216,MM2_jia_DEGREE_TABLE.txt
2408,ZNF543,108,124,232,MM2_jia_DEGREE_TABLE.txt
2409,ZNF557,115,121,236,MM2_jia_DEGREE_TABLE.txt
2410,ZNF574,122,124,246,MM2_jia_DEGREE_TABLE.txt
2411,ZNF579,94,124,218,MM2_jia_DEGREE_TABLE.txt
2412,ZNF580,116,122,238,MM2_jia_DEGREE_TABLE.txt
2413,ZNF581,116,112,228,MM2_jia_DEGREE_TABLE.txt
2414,ZNF592,111,73,184,MM2_jia_DEGREE_TABLE.txt
2415,ZNF595,114,124,238,MM2_jia_DEGREE_TABLE.txt
2416,ZNF643,121,114,235,MM2_jia_DEGREE_TABLE.txt
2417,ZNF688,107,100,207,MM2_jia_DEGREE_TABLE.txt
2418,ZNF689,105,120,225,MM2_jia_DEGREE_TABLE.txt
2419,ZNF718,114,123,237,MM2_jia_DEGREE_TABLE.txt
2420,ZNF764,107,85,192,MM2_jia_DEGREE_TABLE.txt
2421,ZNF768,107,124,231,MM2_jia_DEGREE_TABLE.txt
2422,ZNF771,105,95,200,MM2_jia_DEGREE_TABLE.txt
2423,ZNF784,116,118,234,MM2_jia_DEGREE_TABLE.txt
2424,ZNF785,107,104,211,MM2_jia_DEGREE_TABLE.txt
2425,ZNF791,104,112,216,MM2_jia_DEGREE_TABLE.txt
2426,ZNF805,108,122,230,MM2_jia_DEGREE_TABLE.txt
2427,ARID3A,105,103,208,KMS12_H3K27ac_DEGREE_TABLE.txt
2428,ATF4,104,106,210,KMS12_H3K27ac_DEGREE_TABLE.txt
2429,ATF6,100,71,171,KMS12_H3K27ac_DEGREE_TABLE.txt
2430,BCL11A,100,107,207,KMS12_H3K27ac_DEGREE_TABLE.txt
2431,BHLHE40,101,94,195,KMS12_H3K27ac_DEGREE_TABLE.txt
2432,BHLHE41,107,71,178,KMS12_H3K27ac_DEGREE_TABLE.txt
2433,CAMTA2,100,34,134,KMS12_H3K27ac_DEGREE_TABLE.txt
2434,CEBPB,88,105,193,KMS12_H3K27ac_DEGREE_TABLE.txt
2435,CHD2,100,106,206,KMS12_H3K27ac_DEGREE_TABLE.txt
2436,CREB3L2,104,99,203,KMS12_H3K27ac_DEGREE_TABLE.txt
2437,CREB3L4,105,87,192,KMS12_H3K27ac_DEGREE_TABLE.txt
2438,DBP,97,102,199,KMS12_H3K27ac_DEGREE_TABLE.txt
2439,DDIT3,98,104,202,KMS12_H3K27ac_DEGREE_TABLE.txt
2440,E4F1,98,105,203,KMS12_H3K27ac_DEGREE_TABLE.txt
2441,ELF1,96,107,203,KMS12_H3K27ac_DEGREE_TABLE.txt
2442,ETV6,105,105,210,KMS12_H3K27ac_DEGREE_TABLE.txt
2443,FBP1,92,102,194,KMS12_H3K27ac_DEGREE_TABLE.txt
2444,FBP2,92,106,198,KMS12_H3K27ac_DEGREE_TABLE.txt
2445,FIZ1,103,107,210,KMS12_H3K27ac_DEGREE_TABLE.txt
2446,FLI1,105,107,212,KMS12_H3K27ac_DEGREE_TABLE.txt
2447,FOSL1,96,97,193,KMS12_H3K27ac_DEGREE_TABLE.txt
2448,FOXH1,99,100,199,KMS12_H3K27ac_DEGREE_TABLE.txt
2449,FOXN3,104,89,193,KMS12_H3K27ac_DEGREE_TABLE.txt
2450,FOXP1,102,107,209,KMS12_H3K27ac_DEGREE_TABLE.txt
2451,FOXR1,91,106,197,KMS12_H3K27ac_DEGREE_TABLE.txt
2452,GLI1,101,105,206,KMS12_H3K27ac_DEGREE_TABLE.txt
2453,GMEB2,99,86,185,KMS12_H3K27ac_DEGREE_TABLE.txt
2454,GZF1,103,66,169,KMS12_H3K27ac_DEGREE_TABLE.txt
2455,HES1,105,107,212,KMS12_H3K27ac_DEGREE_TABLE.txt
2456,HEY2,100,81,181,KMS12_H3K27ac_DEGREE_TABLE.txt
2457,HINFP,103,101,204,KMS12_H3K27ac_DEGREE_TABLE.txt
2458,HIVEP2,99,106,205,KMS12_H3K27ac_DEGREE_TABLE.txt
2459,HNF1B,99,97,196,KMS12_H3K27ac_DEGREE_TABLE.txt
2460,IKZF1,104,106,210,KMS12_H3K27ac_DEGREE_TABLE.txt
2461,IKZF3,97,107,204,KMS12_H3K27ac_DEGREE_TABLE.txt
2462,IRF2,104,94,198,KMS12_H3K27ac_DEGREE_TABLE.txt
2463,IRF4,107,104,211,KMS12_H3K27ac_DEGREE_TABLE.txt
2464,IRF5,94,99,193,KMS12_H3K27ac_DEGREE_TABLE.txt
2465,JUNB,105,105,210,KMS12_H3K27ac_DEGREE_TABLE.txt
2466,KLF1,105,107,212,KMS12_H3K27ac_DEGREE_TABLE.txt
2467,KLF10,94,105,199,KMS12_H3K27ac_DEGREE_TABLE.txt
2468,KLF13,106,95,201,KMS12_H3K27ac_DEGREE_TABLE.txt
2469,KLF2,100,105,205,KMS12_H3K27ac_DEGREE_TABLE.txt
2470,LBX2,103,99,202,KMS12_H3K27ac_DEGREE_TABLE.txt
2471,MAZ,103,107,210,KMS12_H3K27ac_DEGREE_TABLE.txt
2472,MEF2D,102,106,208,KMS12_H3K27ac_DEGREE_TABLE.txt
2473,MNX1,104,93,197,KMS12_H3K27ac_DEGREE_TABLE.txt
2474,MXI1,104,106,210,KMS12_H3K27ac_DEGREE_TABLE.txt
2475,MYC,99,103,202,KMS12_H3K27ac_DEGREE_TABLE.txt
2476,MZF1,97,107,204,KMS12_H3K27ac_DEGREE_TABLE.txt
2477,NFATC1,93,107,200,KMS12_H3K27ac_DEGREE_TABLE.txt
2478,NFATC3,93,99,192,KMS12_H3K27ac_DEGREE_TABLE.txt
2479,NFE2L1,102,91,193,KMS12_H3K27ac_DEGREE_TABLE.txt
2480,NFE2L2,103,104,207,KMS12_H3K27ac_DEGREE_TABLE.txt
2481,NFE2L3,106,107,213,KMS12_H3K27ac_DEGREE_TABLE.txt
2482,NFIX,106,107,213,KMS12_H3K27ac_DEGREE_TABLE.txt
2483,NR1D1,104,107,211,KMS12_H3K27ac_DEGREE_TABLE.txt
2484,NR3C1,102,106,208,KMS12_H3K27ac_DEGREE_TABLE.txt
2485,NR4A2,101,106,207,KMS12_H3K27ac_DEGREE_TABLE.txt
2486,OVOL1,93,86,179,KMS12_H3K27ac_DEGREE_TABLE.txt
2487,PBX2,95,96,191,KMS12_H3K27ac_DEGREE_TABLE.txt
2488,POU2F1,89,107,196,KMS12_H3K27ac_DEGREE_TABLE.txt
2489,POU5F1,105,106,211,KMS12_H3K27ac_DEGREE_TABLE.txt
2490,PRDM1,106,107,213,KMS12_H3K27ac_DEGREE_TABLE.txt
2491,PRDM10,88,83,171,KMS12_H3K27ac_DEGREE_TABLE.txt
2492,RELA,94,107,201,KMS12_H3K27ac_DEGREE_TABLE.txt
2493,RFX7,94,62,156,KMS12_H3K27ac_DEGREE_TABLE.txt
2494,RORA,104,107,211,KMS12_H3K27ac_DEGREE_TABLE.txt
2495,RREB1,103,107,210,KMS12_H3K27ac_DEGREE_TABLE.txt
2496,RUNX1,106,104,210,KMS12_H3K27ac_DEGREE_TABLE.txt
2497,RUNX2,99,105,204,KMS12_H3K27ac_DEGREE_TABLE.txt
2498,SIN3A,93,107,200,KMS12_H3K27ac_DEGREE_TABLE.txt
2499,SMAD2,94,100,194,KMS12_H3K27ac_DEGREE_TABLE.txt
2500,SMAD7,107,102,209,KMS12_H3K27ac_DEGREE_TABLE.txt
2501,SOX12,92,107,199,KMS12_H3K27ac_DEGREE_TABLE.txt
2502,SOX5,100,102,202,KMS12_H3K27ac_DEGREE_TABLE.txt
2503,STAT6,100,107,207,KMS12_H3K27ac_DEGREE_TABLE.txt
2504,TCF12,87,107,194,KMS12_H3K27ac_DEGREE_TABLE.txt
2505,TCF4,94,105,199,KMS12_H3K27ac_DEGREE_TABLE.txt
2506,THAP1,103,107,210,KMS12_H3K27ac_DEGREE_TABLE.txt
2507,THRA,104,106,210,KMS12_H3K27ac_DEGREE_TABLE.txt
2508,TLX2,103,106,209,KMS12_H3K27ac_DEGREE_TABLE.txt
2509,XBP1,103,87,190,KMS12_H3K27ac_DEGREE_TABLE.txt
2510,ZBTB38,100,102,202,KMS12_H3K27ac_DEGREE_TABLE.txt
2511,ZBTB7B,107,105,212,KMS12_H3K27ac_DEGREE_TABLE.txt
2512,ZFP62,105,107,212,KMS12_H3K27ac_DEGREE_TABLE.txt
2513,ZFP91,102,107,209,KMS12_H3K27ac_DEGREE_TABLE.txt
2514,ZNF114,102,85,187,KMS12_H3K27ac_DEGREE_TABLE.txt
2515,ZNF143,94,100,194,KMS12_H3K27ac_DEGREE_TABLE.txt
2516,ZNF217,105,81,186,KMS12_H3K27ac_DEGREE_TABLE.txt
2517,ZNF251,101,106,207,KMS12_H3K27ac_DEGREE_TABLE.txt
2518,ZNF3,95,93,188,KMS12_H3K27ac_DEGREE_TABLE.txt
2519,ZNF34,101,90,191,KMS12_H3K27ac_DEGREE_TABLE.txt
2520,ZNF407,86,107,193,KMS12_H3K27ac_DEGREE_TABLE.txt
2521,ZNF48,104,103,207,KMS12_H3K27ac_DEGREE_TABLE.txt
2522,ZNF517,101,107,208,KMS12_H3K27ac_DEGREE_TABLE.txt
2523,ZNF524,103,106,209,KMS12_H3K27ac_DEGREE_TABLE.txt
2524,ZNF580,103,105,208,KMS12_H3K27ac_DEGREE_TABLE.txt
2525,ZNF581,103,106,209,KMS12_H3K27ac_DEGREE_TABLE.txt
2526,ZNF652,99,107,206,KMS12_H3K27ac_DEGREE_TABLE.txt
2527,ZNF688,95,93,188,KMS12_H3K27ac_DEGREE_TABLE.txt
2528,ZNF689,90,105,195,KMS12_H3K27ac_DEGREE_TABLE.txt
2529,ZNF764,95,76,171,KMS12_H3K27ac_DEGREE_TABLE.txt
2530,ZNF768,95,107,202,KMS12_H3K27ac_DEGREE_TABLE.txt
2531,ZNF775,106,106,212,KMS12_H3K27ac_DEGREE_TABLE.txt
2532,ZNF784,103,107,210,KMS12_H3K27ac_DEGREE_TABLE.txt
2533,ZNF785,95,96,191,KMS12_H3K27ac_DEGREE_TABLE.txt
2534,ARF1,104,43,147,NCI-H929.H3K27ac_DEGREE_TABLE.txt
2535,ARID3A,104,107,211,NCI-H929.H3K27ac_DEGREE_TABLE.txt
2536,ARID5A,106,113,219,NCI-H929.H3K27ac_DEGREE_TABLE.txt
2537,ARNT,113,81,194,NCI-H929.H3K27ac_DEGREE_TABLE.txt
2538,ATF4,109,112,221,NCI-H929.H3K27ac_DEGREE_TABLE.txt
2539,ATF5,110,115,225,NCI-H929.H3K27ac_DEGREE_TABLE.txt
2540,ATF6,111,72,183,NCI-H929.H3K27ac_DEGREE_TABLE.txt
2541,CAMTA2,111,29,140,NCI-H929.H3K27ac_DEGREE_TABLE.txt
2542,CEBPB,93,106,199,NCI-H929.H3K27ac_DEGREE_TABLE.txt
2543,CHD2,98,114,212,NCI-H929.H3K27ac_DEGREE_TABLE.txt
2544,CREB3L4,117,84,201,NCI-H929.H3K27ac_DEGREE_TABLE.txt
2545,CTCF,103,120,223,NCI-H929.H3K27ac_DEGREE_TABLE.txt
2546,CTCFL,113,120,233,NCI-H929.H3K27ac_DEGREE_TABLE.txt
2547,CUX1,110,102,212,NCI-H929.H3K27ac_DEGREE_TABLE.txt
2548,DEAF1,86,107,193,NCI-H929.H3K27ac_DEGREE_TABLE.txt
2549,DMRTC2,113,82,195,NCI-H929.H3K27ac_DEGREE_TABLE.txt
2550,E2F2,106,114,220,NCI-H929.H3K27ac_DEGREE_TABLE.txt
2551,E2F3,107,120,227,NCI-H929.H3K27ac_DEGREE_TABLE.txt
2552,ETV3,109,87,196,NCI-H929.H3K27ac_DEGREE_TABLE.txt
2553,FIZ1,105,120,225,NCI-H929.H3K27ac_DEGREE_TABLE.txt
2554,FLI1,117,120,237,NCI-H929.H3K27ac_DEGREE_TABLE.txt
2555,FOSB,109,45,154,NCI-H929.H3K27ac_DEGREE_TABLE.txt
2556,FOSL1,104,88,192,NCI-H929.H3K27ac_DEGREE_TABLE.txt
2557,FOSL2,100,101,201,NCI-H929.H3K27ac_DEGREE_TABLE.txt
2558,FOXO3,106,120,226,NCI-H929.H3K27ac_DEGREE_TABLE.txt
2559,FOXP2,95,114,209,NCI-H929.H3K27ac_DEGREE_TABLE.txt
2560,FOXR1,117,110,227,NCI-H929.H3K27ac_DEGREE_TABLE.txt
2561,GFI1,108,116,224,NCI-H929.H3K27ac_DEGREE_TABLE.txt
2562,GMEB2,91,73,164,NCI-H929.H3K27ac_DEGREE_TABLE.txt
2563,HES1,109,116,225,NCI-H929.H3K27ac_DEGREE_TABLE.txt
2564,HES5,106,87,193,NCI-H929.H3K27ac_DEGREE_TABLE.txt
2565,HES7,105,119,224,NCI-H929.H3K27ac_DEGREE_TABLE.txt
2566,HINFP,113,114,227,NCI-H929.H3K27ac_DEGREE_TABLE.txt
2567,IKZF3,109,120,229,NCI-H929.H3K27ac_DEGREE_TABLE.txt
2568,IRF1,116,120,236,NCI-H929.H3K27ac_DEGREE_TABLE.txt
2569,IRF2,119,112,231,NCI-H929.H3K27ac_DEGREE_TABLE.txt
2570,IRF4,111,110,221,NCI-H929.H3K27ac_DEGREE_TABLE.txt
2571,JUNB,108,108,216,NCI-H929.H3K27ac_DEGREE_TABLE.txt
2572,JUND,97,120,217,NCI-H929.H3K27ac_DEGREE_TABLE.txt
2573,KLF1,112,120,232,NCI-H929.H3K27ac_DEGREE_TABLE.txt
2574,KLF10,104,119,223,NCI-H929.H3K27ac_DEGREE_TABLE.txt
2575,KLF13,118,90,208,NCI-H929.H3K27ac_DEGREE_TABLE.txt
2576,KLF16,108,119,227,NCI-H929.H3K27ac_DEGREE_TABLE.txt
2577,KLF2,109,119,228,NCI-H929.H3K27ac_DEGREE_TABLE.txt
2578,KLF6,107,104,211,NCI-H929.H3K27ac_DEGREE_TABLE.txt
2579,KLF9,106,119,225,NCI-H929.H3K27ac_DEGREE_TABLE.txt
2580,MAF,110,119,229,NCI-H929.H3K27ac_DEGREE_TABLE.txt
2581,MAFF,113,120,233,NCI-H929.H3K27ac_DEGREE_TABLE.txt
2582,MAZ,102,120,222,NCI-H929.H3K27ac_DEGREE_TABLE.txt
2583,MEF2C,111,118,229,NCI-H929.H3K27ac_DEGREE_TABLE.txt
2584,MEF2D,115,113,228,NCI-H929.H3K27ac_DEGREE_TABLE.txt
2585,MNT,110,73,183,NCI-H929.H3K27ac_DEGREE_TABLE.txt
2586,MYBL2,106,89,195,NCI-H929.H3K27ac_DEGREE_TABLE.txt
2587,NFATC2,113,118,231,NCI-H929.H3K27ac_DEGREE_TABLE.txt
2588,NFE2L2,104,101,205,NCI-H929.H3K27ac_DEGREE_TABLE.txt
2589,NFE2L3,98,120,218,NCI-H929.H3K27ac_DEGREE_TABLE.txt
2590,NFIC,98,111,209,NCI-H929.H3K27ac_DEGREE_TABLE.txt
2591,NFIX,112,112,224,NCI-H929.H3K27ac_DEGREE_TABLE.txt
2592,NR1I3,114,84,198,NCI-H929.H3K27ac_DEGREE_TABLE.txt
2593,NR3C1,110,112,222,NCI-H929.H3K27ac_DEGREE_TABLE.txt
2594,PBX4,109,94,203,NCI-H929.H3K27ac_DEGREE_TABLE.txt
2595,POU2F1,93,120,213,NCI-H929.H3K27ac_DEGREE_TABLE.txt
2596,PRDM1,118,118,236,NCI-H929.H3K27ac_DEGREE_TABLE.txt
2597,PRDM10,81,87,168,NCI-H929.H3K27ac_DEGREE_TABLE.txt
2598,RARA,114,120,234,NCI-H929.H3K27ac_DEGREE_TABLE.txt
2599,RARG,109,120,229,NCI-H929.H3K27ac_DEGREE_TABLE.txt
2600,RUNX1,103,109,212,NCI-H929.H3K27ac_DEGREE_TABLE.txt
2601,RUNX2,119,117,236,NCI-H929.H3K27ac_DEGREE_TABLE.txt
2602,RUNX3,113,117,230,NCI-H929.H3K27ac_DEGREE_TABLE.txt
2603,RXRB,103,115,218,NCI-H929.H3K27ac_DEGREE_TABLE.txt
2604,SF1,93,94,187,NCI-H929.H3K27ac_DEGREE_TABLE.txt
2605,SIN3A,101,120,221,NCI-H929.H3K27ac_DEGREE_TABLE.txt
2606,SMAD2,89,101,190,NCI-H929.H3K27ac_DEGREE_TABLE.txt
2607,SMAD7,119,102,221,NCI-H929.H3K27ac_DEGREE_TABLE.txt
2608,SOX11,106,120,226,NCI-H929.H3K27ac_DEGREE_TABLE.txt
2609,SOX15,107,120,227,NCI-H929.H3K27ac_DEGREE_TABLE.txt
2610,SP3,82,120,202,NCI-H929.H3K27ac_DEGREE_TABLE.txt
2611,SREBF1,118,112,230,NCI-H929.H3K27ac_DEGREE_TABLE.txt
2612,SRF,95,120,215,NCI-H929.H3K27ac_DEGREE_TABLE.txt
2613,TBX6,95,100,195,NCI-H929.H3K27ac_DEGREE_TABLE.txt
2614,TCF3,114,120,234,NCI-H929.H3K27ac_DEGREE_TABLE.txt
2615,TCFL5,114,91,205,NCI-H929.H3K27ac_DEGREE_TABLE.txt
2616,TEF,100,112,212,NCI-H929.H3K27ac_DEGREE_TABLE.txt
2617,TFAP2A,91,120,211,NCI-H929.H3K27ac_DEGREE_TABLE.txt
2618,TFAP4,92,91,183,NCI-H929.H3K27ac_DEGREE_TABLE.txt
2619,THAP1,114,120,234,NCI-H929.H3K27ac_DEGREE_TABLE.txt
2620,USF1,102,103,205,NCI-H929.H3K27ac_DEGREE_TABLE.txt
2621,XBP1,118,88,206,NCI-H929.H3K27ac_DEGREE_TABLE.txt
2622,ZBTB1,104,92,196,NCI-H929.H3K27ac_DEGREE_TABLE.txt
2623,ZBTB38,118,109,227,NCI-H929.H3K27ac_DEGREE_TABLE.txt
2624,ZBTB44,86,0,86,NCI-H929.H3K27ac_DEGREE_TABLE.txt
2625,ZBTB7B,118,111,229,NCI-H929.H3K27ac_DEGREE_TABLE.txt
2626,ZEB1,91,115,206,NCI-H929.H3K27ac_DEGREE_TABLE.txt
2627,ZFP62,101,118,219,NCI-H929.H3K27ac_DEGREE_TABLE.txt
2628,ZFP91,103,110,213,NCI-H929.H3K27ac_DEGREE_TABLE.txt
2629,ZNF114,108,84,192,NCI-H929.H3K27ac_DEGREE_TABLE.txt
2630,ZNF132,114,120,234,NCI-H929.H3K27ac_DEGREE_TABLE.txt
2631,ZNF143,89,114,203,NCI-H929.H3K27ac_DEGREE_TABLE.txt
2632,ZNF217,117,74,191,NCI-H929.H3K27ac_DEGREE_TABLE.txt
2633,ZNF219,102,119,221,NCI-H929.H3K27ac_DEGREE_TABLE.txt
2634,ZNF236,86,120,206,NCI-H929.H3K27ac_DEGREE_TABLE.txt
2635,ZNF334,107,107,214,NCI-H929.H3K27ac_DEGREE_TABLE.txt
2636,ZNF335,111,117,228,NCI-H929.H3K27ac_DEGREE_TABLE.txt
2637,ZNF367,109,93,202,NCI-H929.H3K27ac_DEGREE_TABLE.txt
2638,ZNF436,95,120,215,NCI-H929.H3K27ac_DEGREE_TABLE.txt
2639,ZNF48,111,119,230,NCI-H929.H3K27ac_DEGREE_TABLE.txt
2640,ZNF490,106,103,209,NCI-H929.H3K27ac_DEGREE_TABLE.txt
2641,ZNF497,114,116,230,NCI-H929.H3K27ac_DEGREE_TABLE.txt
2642,ZNF524,105,119,224,NCI-H929.H3K27ac_DEGREE_TABLE.txt
2643,ZNF580,105,116,221,NCI-H929.H3K27ac_DEGREE_TABLE.txt
2644,ZNF581,105,108,213,NCI-H929.H3K27ac_DEGREE_TABLE.txt
2645,ZNF584,114,97,211,NCI-H929.H3K27ac_DEGREE_TABLE.txt
2646,ZNF652,97,119,216,NCI-H929.H3K27ac_DEGREE_TABLE.txt
2647,ZNF681,103,120,223,NCI-H929.H3K27ac_DEGREE_TABLE.txt
2648,ZNF687,91,68,159,NCI-H929.H3K27ac_DEGREE_TABLE.txt
2649,ZNF740,109,120,229,NCI-H929.H3K27ac_DEGREE_TABLE.txt
2650,ZNF775,112,112,224,NCI-H929.H3K27ac_DEGREE_TABLE.txt
2651,ZNF784,105,119,224,NCI-H929.H3K27ac_DEGREE_TABLE.txt
2652,ZNF791,106,107,213,NCI-H929.H3K27ac_DEGREE_TABLE.txt
2653,ZNF837,114,118,232,NCI-H929.H3K27ac_DEGREE_TABLE.txt
2654,ARF1,49,14,63,MM25.H3K27ac_DEGREE_TABLE.txt
2655,BACH1,74,50,124,MM25.H3K27ac_DEGREE_TABLE.txt
2656,BCL6B,81,87,168,MM25.H3K27ac_DEGREE_TABLE.txt
2657,BCLAF1,72,94,166,MM25.H3K27ac_DEGREE_TABLE.txt
2658,BHLHE41,83,27,110,MM25.H3K27ac_DEGREE_TABLE.txt
2659,BRCA1,77,14,91,MM25.H3K27ac_DEGREE_TABLE.txt
2660,CAMTA2,70,15,85,MM25.H3K27ac_DEGREE_TABLE.txt
2661,CEBPB,69,61,130,MM25.H3K27ac_DEGREE_TABLE.txt
2662,CEBPG,64,83,147,MM25.H3K27ac_DEGREE_TABLE.txt
2663,CHD2,86,74,160,MM25.H3K27ac_DEGREE_TABLE.txt
2664,CREB1,63,77,140,MM25.H3K27ac_DEGREE_TABLE.txt
2665,CREM,64,65,129,MM25.H3K27ac_DEGREE_TABLE.txt
2666,ELF2,58,65,123,MM25.H3K27ac_DEGREE_TABLE.txt
2667,ERF,76,61,137,MM25.H3K27ac_DEGREE_TABLE.txt
2668,ESRRA,88,90,178,MM25.H3K27ac_DEGREE_TABLE.txt
2669,FIZ1,55,81,136,MM25.H3K27ac_DEGREE_TABLE.txt
2670,FOS,81,82,163,MM25.H3K27ac_DEGREE_TABLE.txt
2671,FOSB,80,41,121,MM25.H3K27ac_DEGREE_TABLE.txt
2672,FOXN3,67,58,125,MM25.H3K27ac_DEGREE_TABLE.txt
2673,FOXO3,70,93,163,MM25.H3K27ac_DEGREE_TABLE.txt
2674,FOXP2,71,73,144,MM25.H3K27ac_DEGREE_TABLE.txt
2675,HAP1,65,6,71,MM25.H3K27ac_DEGREE_TABLE.txt
2676,HBP1,76,79,155,MM25.H3K27ac_DEGREE_TABLE.txt
2677,HIVEP2,81,63,144,MM25.H3K27ac_DEGREE_TABLE.txt
2678,IRF1,89,95,184,MM25.H3K27ac_DEGREE_TABLE.txt
2679,IRF2,70,75,145,MM25.H3K27ac_DEGREE_TABLE.txt
2680,IRF3,72,93,165,MM25.H3K27ac_DEGREE_TABLE.txt
2681,ISL2,82,84,166,MM25.H3K27ac_DEGREE_TABLE.txt
2682,JUN,73,76,149,MM25.H3K27ac_DEGREE_TABLE.txt
2683,JUNB,85,79,164,MM25.H3K27ac_DEGREE_TABLE.txt
2684,JUND,66,94,160,MM25.H3K27ac_DEGREE_TABLE.txt
2685,KLF10,73,92,165,MM25.H3K27ac_DEGREE_TABLE.txt
2686,KLF13,89,46,135,MM25.H3K27ac_DEGREE_TABLE.txt
2687,KLF2,80,75,155,MM25.H3K27ac_DEGREE_TABLE.txt
2688,KLF6,84,47,131,MM25.H3K27ac_DEGREE_TABLE.txt
2689,KLF7,55,89,144,MM25.H3K27ac_DEGREE_TABLE.txt
2690,LHX6,68,72,140,MM25.H3K27ac_DEGREE_TABLE.txt
2691,MEF2A,63,91,154,MM25.H3K27ac_DEGREE_TABLE.txt
2692,MNT,69,22,91,MM25.H3K27ac_DEGREE_TABLE.txt
2693,MXI1,82,70,152,MM25.H3K27ac_DEGREE_TABLE.txt
2694,MYC,76,50,126,MM25.H3K27ac_DEGREE_TABLE.txt
2695,MYNN,63,42,105,MM25.H3K27ac_DEGREE_TABLE.txt
2696,MZF1,75,93,168,MM25.H3K27ac_DEGREE_TABLE.txt
2697,NFE2L2,67,59,126,MM25.H3K27ac_DEGREE_TABLE.txt
2698,NFKB1,54,93,147,MM25.H3K27ac_DEGREE_TABLE.txt
2699,NFKB2,67,69,136,MM25.H3K27ac_DEGREE_TABLE.txt
2700,NR1D2,70,36,106,MM25.H3K27ac_DEGREE_TABLE.txt
2701,NR3C1,77,80,157,MM25.H3K27ac_DEGREE_TABLE.txt
2702,NR4A2,63,84,147,MM25.H3K27ac_DEGREE_TABLE.txt
2703,NR4A3,79,55,134,MM25.H3K27ac_DEGREE_TABLE.txt
2704,POU6F1,59,86,145,MM25.H3K27ac_DEGREE_TABLE.txt
2705,PRDM1,80,94,174,MM25.H3K27ac_DEGREE_TABLE.txt
2706,PRDM10,61,33,94,MM25.H3K27ac_DEGREE_TABLE.txt
2707,RARA,78,95,173,MM25.H3K27ac_DEGREE_TABLE.txt
2708,RELA,82,94,176,MM25.H3K27ac_DEGREE_TABLE.txt
2709,RELB,52,47,99,MM25.H3K27ac_DEGREE_TABLE.txt
2710,RFX1,67,85,152,MM25.H3K27ac_DEGREE_TABLE.txt
2711,RFX3,75,80,155,MM25.H3K27ac_DEGREE_TABLE.txt
2712,RUNX1,74,58,132,MM25.H3K27ac_DEGREE_TABLE.txt
2713,SF1,74,48,122,MM25.H3K27ac_DEGREE_TABLE.txt
2714,SIN3A,86,94,180,MM25.H3K27ac_DEGREE_TABLE.txt
2715,SP3,55,88,143,MM25.H3K27ac_DEGREE_TABLE.txt
2716,TBX6,74,58,132,MM25.H3K27ac_DEGREE_TABLE.txt
2717,TCF12,66,85,151,MM25.H3K27ac_DEGREE_TABLE.txt
2718,TCF3,50,95,145,MM25.H3K27ac_DEGREE_TABLE.txt
2719,TGIF2,72,59,131,MM25.H3K27ac_DEGREE_TABLE.txt
2720,TP53,71,73,144,MM25.H3K27ac_DEGREE_TABLE.txt
2721,USF1,75,57,132,MM25.H3K27ac_DEGREE_TABLE.txt
2722,XBP1,76,71,147,MM25.H3K27ac_DEGREE_TABLE.txt
2723,ZBTB1,68,35,103,MM25.H3K27ac_DEGREE_TABLE.txt
2724,ZBTB3,68,81,149,MM25.H3K27ac_DEGREE_TABLE.txt
2725,ZBTB32,53,52,105,MM25.H3K27ac_DEGREE_TABLE.txt
2726,ZBTB5,64,83,147,MM25.H3K27ac_DEGREE_TABLE.txt
2727,ZFP91,80,66,146,MM25.H3K27ac_DEGREE_TABLE.txt
2728,ZNF143,63,72,135,MM25.H3K27ac_DEGREE_TABLE.txt
2729,ZNF460,67,94,161,MM25.H3K27ac_DEGREE_TABLE.txt
2730,ZNF48,56,74,130,MM25.H3K27ac_DEGREE_TABLE.txt
2731,ZNF483,61,76,137,MM25.H3K27ac_DEGREE_TABLE.txt
2732,ZNF490,53,43,96,MM25.H3K27ac_DEGREE_TABLE.txt
2733,ZNF524,55,82,137,MM25.H3K27ac_DEGREE_TABLE.txt
2734,ZNF526,76,87,163,MM25.H3K27ac_DEGREE_TABLE.txt
2735,ZNF542,65,65,130,MM25.H3K27ac_DEGREE_TABLE.txt
2736,ZNF543,67,82,149,MM25.H3K27ac_DEGREE_TABLE.txt
2737,ZNF574,71,93,164,MM25.H3K27ac_DEGREE_TABLE.txt
2738,ZNF580,80,76,156,MM25.H3K27ac_DEGREE_TABLE.txt
2739,ZNF581,80,61,141,MM25.H3K27ac_DEGREE_TABLE.txt
2740,ZNF592,62,28,90,MM25.H3K27ac_DEGREE_TABLE.txt
2741,ZNF672,41,85,126,MM25.H3K27ac_DEGREE_TABLE.txt
2742,ZNF689,67,83,150,MM25.H3K27ac_DEGREE_TABLE.txt
2743,ZNF692,41,84,125,MM25.H3K27ac_DEGREE_TABLE.txt
2744,ZNF771,56,56,112,MM25.H3K27ac_DEGREE_TABLE.txt
2745,ZNF775,63,85,148,MM25.H3K27ac_DEGREE_TABLE.txt
2746,ZNF784,80,88,168,MM25.H3K27ac_DEGREE_TABLE.txt
2747,ZNF791,53,64,117,MM25.H3K27ac_DEGREE_TABLE.txt
2748,ZNF805,67,86,153,MM25.H3K27ac_DEGREE_TABLE.txt
2749,ARID3B,56,46,102,LP-1.H3K27ac_DEGREE_TABLE.txt
2750,BCL6B,60,63,123,LP-1.H3K27ac_DEGREE_TABLE.txt
2751,CAMTA1,55,22,77,LP-1.H3K27ac_DEGREE_TABLE.txt
2752,CAMTA2,53,16,69,LP-1.H3K27ac_DEGREE_TABLE.txt
2753,CEBPB,52,52,104,LP-1.H3K27ac_DEGREE_TABLE.txt
2754,CHD2,53,60,113,LP-1.H3K27ac_DEGREE_TABLE.txt
2755,CREB3L4,44,43,87,LP-1.H3K27ac_DEGREE_TABLE.txt
2756,CST6,60,19,79,LP-1.H3K27ac_DEGREE_TABLE.txt
2757,CUX1,61,50,111,LP-1.H3K27ac_DEGREE_TABLE.txt
2758,DDIT3,54,57,111,LP-1.H3K27ac_DEGREE_TABLE.txt
2759,E2F2,56,61,117,LP-1.H3K27ac_DEGREE_TABLE.txt
2760,E2F3,51,63,114,LP-1.H3K27ac_DEGREE_TABLE.txt
2761,E2F6,54,63,117,LP-1.H3K27ac_DEGREE_TABLE.txt
2762,FLI1,59,62,121,LP-1.H3K27ac_DEGREE_TABLE.txt
2763,FOSL1,54,50,104,LP-1.H3K27ac_DEGREE_TABLE.txt
2764,FOXN3,56,44,100,LP-1.H3K27ac_DEGREE_TABLE.txt
2765,GMEB2,45,35,80,LP-1.H3K27ac_DEGREE_TABLE.txt
2766,IKZF1,58,61,119,LP-1.H3K27ac_DEGREE_TABLE.txt
2767,IRF2,61,55,116,LP-1.H3K27ac_DEGREE_TABLE.txt
2768,IRF4,58,59,117,LP-1.H3K27ac_DEGREE_TABLE.txt
2769,JUN,45,61,106,LP-1.H3K27ac_DEGREE_TABLE.txt
2770,KLF10,52,63,115,LP-1.H3K27ac_DEGREE_TABLE.txt
2771,KLF13,59,44,103,LP-1.H3K27ac_DEGREE_TABLE.txt
2772,KLF2,60,61,121,LP-1.H3K27ac_DEGREE_TABLE.txt
2773,KLF6,60,55,115,LP-1.H3K27ac_DEGREE_TABLE.txt
2774,MAF,60,61,121,LP-1.H3K27ac_DEGREE_TABLE.txt
2775,MAZ,52,63,115,LP-1.H3K27ac_DEGREE_TABLE.txt
2776,MEF2C,62,60,122,LP-1.H3K27ac_DEGREE_TABLE.txt
2777,MEF2D,60,60,120,LP-1.H3K27ac_DEGREE_TABLE.txt
2778,MXI1,61,61,122,LP-1.H3K27ac_DEGREE_TABLE.txt
2779,MYBL2,57,49,106,LP-1.H3K27ac_DEGREE_TABLE.txt
2780,MYC,60,53,113,LP-1.H3K27ac_DEGREE_TABLE.txt
2781,NFIL3,57,54,111,LP-1.H3K27ac_DEGREE_TABLE.txt
2782,NR3C1,58,61,119,LP-1.H3K27ac_DEGREE_TABLE.txt
2783,POU2F1,50,62,112,LP-1.H3K27ac_DEGREE_TABLE.txt
2784,PRDM1,63,61,124,LP-1.H3K27ac_DEGREE_TABLE.txt
2785,RARA,58,63,121,LP-1.H3K27ac_DEGREE_TABLE.txt
2786,RARG,59,63,122,LP-1.H3K27ac_DEGREE_TABLE.txt
2787,RFX5,53,62,115,LP-1.H3K27ac_DEGREE_TABLE.txt
2788,RORA,60,62,122,LP-1.H3K27ac_DEGREE_TABLE.txt
2789,RUNX2,60,61,121,LP-1.H3K27ac_DEGREE_TABLE.txt
2790,SIN3A,47,63,110,LP-1.H3K27ac_DEGREE_TABLE.txt
2791,SMAD3,58,63,121,LP-1.H3K27ac_DEGREE_TABLE.txt
2792,SMAD7,63,55,118,LP-1.H3K27ac_DEGREE_TABLE.txt
2793,SREBF1,55,60,115,LP-1.H3K27ac_DEGREE_TABLE.txt
2794,SREBF2,59,58,117,LP-1.H3K27ac_DEGREE_TABLE.txt
2795,SRF,46,63,109,LP-1.H3K27ac_DEGREE_TABLE.txt
2796,TBX6,48,53,101,LP-1.H3K27ac_DEGREE_TABLE.txt
2797,TCF3,55,63,118,LP-1.H3K27ac_DEGREE_TABLE.txt
2798,TCF4,55,61,116,LP-1.H3K27ac_DEGREE_TABLE.txt
2799,TGIF1,54,55,109,LP-1.H3K27ac_DEGREE_TABLE.txt
2800,XBP1,60,42,102,LP-1.H3K27ac_DEGREE_TABLE.txt
2801,ZBTB38,61,60,121,LP-1.H3K27ac_DEGREE_TABLE.txt
2802,ZBTB7B,60,59,119,LP-1.H3K27ac_DEGREE_TABLE.txt
2803,ZFP91,52,54,106,LP-1.H3K27ac_DEGREE_TABLE.txt
2804,ZNF217,58,43,101,LP-1.H3K27ac_DEGREE_TABLE.txt
2805,ZNF22,53,58,111,LP-1.H3K27ac_DEGREE_TABLE.txt
2806,ZNF341,51,63,114,LP-1.H3K27ac_DEGREE_TABLE.txt
2807,ZNF398,47,60,107,LP-1.H3K27ac_DEGREE_TABLE.txt
2808,ZNF425,47,63,110,LP-1.H3K27ac_DEGREE_TABLE.txt
2809,ZNF740,59,63,122,LP-1.H3K27ac_DEGREE_TABLE.txt
2810,ZNF775,58,62,120,LP-1.H3K27ac_DEGREE_TABLE.txt
2811,ZNF786,47,57,104,LP-1.H3K27ac_DEGREE_TABLE.txt
2812,ARID3A,129,135,264,KMS28BM_H3K27ac_DEGREE_TABLE.txt
2813,ATF5,155,154,309,KMS28BM_H3K27ac_DEGREE_TABLE.txt
2814,BCL11A,148,156,304,KMS28BM_H3K27ac_DEGREE_TABLE.txt
2815,BCL6B,145,157,302,KMS28BM_H3K27ac_DEGREE_TABLE.txt
2816,BHLHE22,135,152,287,KMS28BM_H3K27ac_DEGREE_TABLE.txt
2817,BHLHE40,150,135,285,KMS28BM_H3K27ac_DEGREE_TABLE.txt
2818,CAMTA1,154,59,213,KMS28BM_H3K27ac_DEGREE_TABLE.txt
2819,CAMTA2,149,61,210,KMS28BM_H3K27ac_DEGREE_TABLE.txt
2820,CEBPB,132,140,272,KMS28BM_H3K27ac_DEGREE_TABLE.txt
2821,CHD2,156,152,308,KMS28BM_H3K27ac_DEGREE_TABLE.txt
2822,CREB3L2,155,141,296,KMS28BM_H3K27ac_DEGREE_TABLE.txt
2823,CREB3L4,153,130,283,KMS28BM_H3K27ac_DEGREE_TABLE.txt
2824,CST6,148,68,216,KMS28BM_H3K27ac_DEGREE_TABLE.txt
2825,CTCF,127,157,284,KMS28BM_H3K27ac_DEGREE_TABLE.txt
2826,CUX1,154,135,289,KMS28BM_H3K27ac_DEGREE_TABLE.txt
2827,DBP,134,147,281,KMS28BM_H3K27ac_DEGREE_TABLE.txt
2828,DDIT3,142,155,297,KMS28BM_H3K27ac_DEGREE_TABLE.txt
2829,E2F1,140,151,291,KMS28BM_H3K27ac_DEGREE_TABLE.txt
2830,E2F2,153,155,308,KMS28BM_H3K27ac_DEGREE_TABLE.txt
2831,E2F3,147,156,303,KMS28BM_H3K27ac_DEGREE_TABLE.txt
2832,ELF1,152,157,309,KMS28BM_H3K27ac_DEGREE_TABLE.txt
2833,ELF2,131,139,270,KMS28BM_H3K27ac_DEGREE_TABLE.txt
2834,ERF,131,133,264,KMS28BM_H3K27ac_DEGREE_TABLE.txt
2835,ETV1,153,153,306,KMS28BM_H3K27ac_DEGREE_TABLE.txt
2836,ETV5,142,120,262,KMS28BM_H3K27ac_DEGREE_TABLE.txt
2837,FIZ1,154,157,311,KMS28BM_H3K27ac_DEGREE_TABLE.txt
2838,FLI1,145,157,302,KMS28BM_H3K27ac_DEGREE_TABLE.txt
2839,FOSL1,151,134,285,KMS28BM_H3K27ac_DEGREE_TABLE.txt
2840,FOSL2,138,146,284,KMS28BM_H3K27ac_DEGREE_TABLE.txt
2841,FOXH1,129,144,273,KMS28BM_H3K27ac_DEGREE_TABLE.txt
2842,FOXJ1,154,152,306,KMS28BM_H3K27ac_DEGREE_TABLE.txt
2843,FOXN3,152,58,210,KMS28BM_H3K27ac_DEGREE_TABLE.txt
2844,FOXO3,152,156,308,KMS28BM_H3K27ac_DEGREE_TABLE.txt
2845,GFI1,140,156,296,KMS28BM_H3K27ac_DEGREE_TABLE.txt
2846,GLI1,147,157,304,KMS28BM_H3K27ac_DEGREE_TABLE.txt
2847,GZF1,149,79,228,KMS28BM_H3K27ac_DEGREE_TABLE.txt
2848,HBP1,141,152,293,KMS28BM_H3K27ac_DEGREE_TABLE.txt
2849,HES5,147,134,281,KMS28BM_H3K27ac_DEGREE_TABLE.txt
2850,HEY1,136,107,243,KMS28BM_H3K27ac_DEGREE_TABLE.txt
2851,HHEX,140,119,259,KMS28BM_H3K27ac_DEGREE_TABLE.txt
2852,HINFP,150,151,301,KMS28BM_H3K27ac_DEGREE_TABLE.txt
2853,ID1,146,149,295,KMS28BM_H3K27ac_DEGREE_TABLE.txt
2854,IKZF1,145,154,299,KMS28BM_H3K27ac_DEGREE_TABLE.txt
2855,IKZF3,156,157,313,KMS28BM_H3K27ac_DEGREE_TABLE.txt
2856,IRF1,154,157,311,KMS28BM_H3K27ac_DEGREE_TABLE.txt
2857,IRF2,154,143,297,KMS28BM_H3K27ac_DEGREE_TABLE.txt
2858,IRF3,152,156,308,KMS28BM_H3K27ac_DEGREE_TABLE.txt
2859,IRF4,153,150,303,KMS28BM_H3K27ac_DEGREE_TABLE.txt
2860,IRF9,149,150,299,KMS28BM_H3K27ac_DEGREE_TABLE.txt
2861,IRX5,148,138,286,KMS28BM_H3K27ac_DEGREE_TABLE.txt
2862,JUNB,153,150,303,KMS28BM_H3K27ac_DEGREE_TABLE.txt
2863,JUND,119,157,276,KMS28BM_H3K27ac_DEGREE_TABLE.txt
2864,KLF1,150,155,305,KMS28BM_H3K27ac_DEGREE_TABLE.txt
2865,KLF10,153,157,310,KMS28BM_H3K27ac_DEGREE_TABLE.txt
2866,KLF13,156,139,295,KMS28BM_H3K27ac_DEGREE_TABLE.txt
2867,KLF2,149,155,304,KMS28BM_H3K27ac_DEGREE_TABLE.txt
2868,KLF3,144,155,299,KMS28BM_H3K27ac_DEGREE_TABLE.txt
2869,KLF6,152,154,306,KMS28BM_H3K27ac_DEGREE_TABLE.txt
2870,KLF9,150,157,307,KMS28BM_H3K27ac_DEGREE_TABLE.txt
2871,LBX2,148,135,283,KMS28BM_H3K27ac_DEGREE_TABLE.txt
2872,LEF1,138,152,290,KMS28BM_H3K27ac_DEGREE_TABLE.txt
2873,LHX3,155,141,296,KMS28BM_H3K27ac_DEGREE_TABLE.txt
2874,MAFG,141,154,295,KMS28BM_H3K27ac_DEGREE_TABLE.txt
2875,MAZ,155,157,312,KMS28BM_H3K27ac_DEGREE_TABLE.txt
2876,MEF2C,157,150,307,KMS28BM_H3K27ac_DEGREE_TABLE.txt
2877,MEF2D,152,151,303,KMS28BM_H3K27ac_DEGREE_TABLE.txt
2878,MEIS1,131,154,285,KMS28BM_H3K27ac_DEGREE_TABLE.txt
2879,MLX,142,96,238,KMS28BM_H3K27ac_DEGREE_TABLE.txt
2880,MXI1,155,154,309,KMS28BM_H3K27ac_DEGREE_TABLE.txt
2881,MYBL1,136,147,283,KMS28BM_H3K27ac_DEGREE_TABLE.txt
2882,MYBL2,152,120,272,KMS28BM_H3K27ac_DEGREE_TABLE.txt
2883,MYC,156,144,300,KMS28BM_H3K27ac_DEGREE_TABLE.txt
2884,MYNN,146,132,278,KMS28BM_H3K27ac_DEGREE_TABLE.txt
2885,MZF1,135,157,292,KMS28BM_H3K27ac_DEGREE_TABLE.txt
2886,NFAT5,136,155,291,KMS28BM_H3K27ac_DEGREE_TABLE.txt
2887,NFE2,143,129,272,KMS28BM_H3K27ac_DEGREE_TABLE.txt
2888,NFE2L1,152,137,289,KMS28BM_H3K27ac_DEGREE_TABLE.txt
2889,NFE2L3,155,153,308,KMS28BM_H3K27ac_DEGREE_TABLE.txt
2890,NFIC,123,151,274,KMS28BM_H3K27ac_DEGREE_TABLE.txt
2891,NFIL3,150,132,282,KMS28BM_H3K27ac_DEGREE_TABLE.txt
2892,NFIX,150,154,304,KMS28BM_H3K27ac_DEGREE_TABLE.txt
2893,NFKB2,139,149,288,KMS28BM_H3K27ac_DEGREE_TABLE.txt
2894,NKX3-2,139,147,286,KMS28BM_H3K27ac_DEGREE_TABLE.txt
2895,NR1D1,150,157,307,KMS28BM_H3K27ac_DEGREE_TABLE.txt
2896,NR1I3,152,120,272,KMS28BM_H3K27ac_DEGREE_TABLE.txt
2897,NR3C1,149,155,304,KMS28BM_H3K27ac_DEGREE_TABLE.txt
2898,PEG3,147,157,304,KMS28BM_H3K27ac_DEGREE_TABLE.txt
2899,PHOX2A,127,116,243,KMS28BM_H3K27ac_DEGREE_TABLE.txt
2900,PLAGL2,137,157,294,KMS28BM_H3K27ac_DEGREE_TABLE.txt
2901,POU5F1,141,153,294,KMS28BM_H3K27ac_DEGREE_TABLE.txt
2902,PRDM1,157,156,313,KMS28BM_H3K27ac_DEGREE_TABLE.txt
2903,PRDM10,122,124,246,KMS28BM_H3K27ac_DEGREE_TABLE.txt
2904,PRDM14,150,148,298,KMS28BM_H3K27ac_DEGREE_TABLE.txt
2905,RELA,144,157,301,KMS28BM_H3K27ac_DEGREE_TABLE.txt
2906,RELB,150,134,284,KMS28BM_H3K27ac_DEGREE_TABLE.txt
2907,RERE,150,131,281,KMS28BM_H3K27ac_DEGREE_TABLE.txt
2908,RFX3,140,155,295,KMS28BM_H3K27ac_DEGREE_TABLE.txt
2909,RORA,157,157,314,KMS28BM_H3K27ac_DEGREE_TABLE.txt
2910,RUNX1,156,145,301,KMS28BM_H3K27ac_DEGREE_TABLE.txt
2911,RXRB,137,157,294,KMS28BM_H3K27ac_DEGREE_TABLE.txt
2912,SF1,145,136,281,KMS28BM_H3K27ac_DEGREE_TABLE.txt
2913,SIN3A,138,157,295,KMS28BM_H3K27ac_DEGREE_TABLE.txt
2914,SMAD3,154,157,311,KMS28BM_H3K27ac_DEGREE_TABLE.txt
2915,SMAD7,155,143,298,KMS28BM_H3K27ac_DEGREE_TABLE.txt
2916,SOX11,143,157,300,KMS28BM_H3K27ac_DEGREE_TABLE.txt
2917,SOX12,153,154,307,KMS28BM_H3K27ac_DEGREE_TABLE.txt
2918,SOX4,140,156,296,KMS28BM_H3K27ac_DEGREE_TABLE.txt
2919,SP1,151,157,308,KMS28BM_H3K27ac_DEGREE_TABLE.txt
2920,SREBF1,153,146,299,KMS28BM_H3K27ac_DEGREE_TABLE.txt
2921,TBX6,125,151,276,KMS28BM_H3K27ac_DEGREE_TABLE.txt
2922,TCF12,139,157,296,KMS28BM_H3K27ac_DEGREE_TABLE.txt
2923,TCF3,141,157,298,KMS28BM_H3K27ac_DEGREE_TABLE.txt
2924,TFEB,148,112,260,KMS28BM_H3K27ac_DEGREE_TABLE.txt
2925,THAP1,153,157,310,KMS28BM_H3K27ac_DEGREE_TABLE.txt
2926,THAP11,133,149,282,KMS28BM_H3K27ac_DEGREE_TABLE.txt
2927,THRA,141,153,294,KMS28BM_H3K27ac_DEGREE_TABLE.txt
2928,TLX2,148,144,292,KMS28BM_H3K27ac_DEGREE_TABLE.txt
2929,USF1,150,149,299,KMS28BM_H3K27ac_DEGREE_TABLE.txt
2930,USF2,94,155,249,KMS28BM_H3K27ac_DEGREE_TABLE.txt
2931,XBP1,155,108,263,KMS28BM_H3K27ac_DEGREE_TABLE.txt
2932,ZBTB24,147,157,304,KMS28BM_H3K27ac_DEGREE_TABLE.txt
2933,ZBTB3,147,156,303,KMS28BM_H3K27ac_DEGREE_TABLE.txt
2934,ZBTB32,144,123,267,KMS28BM_H3K27ac_DEGREE_TABLE.txt
2935,ZBTB38,155,149,304,KMS28BM_H3K27ac_DEGREE_TABLE.txt
2936,ZBTB7B,153,155,308,KMS28BM_H3K27ac_DEGREE_TABLE.txt
2937,ZFP62,149,157,306,KMS28BM_H3K27ac_DEGREE_TABLE.txt
2938,ZFP91,146,152,298,KMS28BM_H3K27ac_DEGREE_TABLE.txt
2939,ZFPM1,116,139,255,KMS28BM_H3K27ac_DEGREE_TABLE.txt
2940,ZIM2,147,152,299,KMS28BM_H3K27ac_DEGREE_TABLE.txt
2941,ZNF114,146,125,271,KMS28BM_H3K27ac_DEGREE_TABLE.txt
2942,ZNF184,142,157,299,KMS28BM_H3K27ac_DEGREE_TABLE.txt
2943,ZNF214,123,157,280,KMS28BM_H3K27ac_DEGREE_TABLE.txt
2944,ZNF215,123,145,268,KMS28BM_H3K27ac_DEGREE_TABLE.txt
2945,ZNF217,155,114,269,KMS28BM_H3K27ac_DEGREE_TABLE.txt
2946,ZNF219,147,155,302,KMS28BM_H3K27ac_DEGREE_TABLE.txt
2947,ZNF22,145,145,290,KMS28BM_H3K27ac_DEGREE_TABLE.txt
2948,ZNF251,145,147,292,KMS28BM_H3K27ac_DEGREE_TABLE.txt
2949,ZNF267,144,157,301,KMS28BM_H3K27ac_DEGREE_TABLE.txt
2950,ZNF3,139,134,273,KMS28BM_H3K27ac_DEGREE_TABLE.txt
2951,ZNF334,149,153,302,KMS28BM_H3K27ac_DEGREE_TABLE.txt
2952,ZNF34,145,129,274,KMS28BM_H3K27ac_DEGREE_TABLE.txt
2953,ZNF398,114,153,267,KMS28BM_H3K27ac_DEGREE_TABLE.txt
2954,ZNF407,131,157,288,KMS28BM_H3K27ac_DEGREE_TABLE.txt
2955,ZNF425,114,157,271,KMS28BM_H3K27ac_DEGREE_TABLE.txt
2956,ZNF48,149,150,299,KMS28BM_H3K27ac_DEGREE_TABLE.txt
2957,ZNF483,139,153,292,KMS28BM_H3K27ac_DEGREE_TABLE.txt
2958,ZNF516,141,121,262,KMS28BM_H3K27ac_DEGREE_TABLE.txt
2959,ZNF517,145,155,300,KMS28BM_H3K27ac_DEGREE_TABLE.txt
2960,ZNF524,154,156,310,KMS28BM_H3K27ac_DEGREE_TABLE.txt
2961,ZNF579,124,154,278,KMS28BM_H3K27ac_DEGREE_TABLE.txt
2962,ZNF580,154,154,308,KMS28BM_H3K27ac_DEGREE_TABLE.txt
2963,ZNF581,154,153,307,KMS28BM_H3K27ac_DEGREE_TABLE.txt
2964,ZNF643,152,152,304,KMS28BM_H3K27ac_DEGREE_TABLE.txt
2965,ZNF689,130,155,285,KMS28BM_H3K27ac_DEGREE_TABLE.txt
2966,ZNF775,152,155,307,KMS28BM_H3K27ac_DEGREE_TABLE.txt
2967,ZNF784,154,155,309,KMS28BM_H3K27ac_DEGREE_TABLE.txt
2968,ZNF786,114,149,263,KMS28BM_H3K27ac_DEGREE_TABLE.txt
2969,ARF1,99,59,158,MM3.H3K27ac_DEGREE_TABLE.txt
2970,ARID3A,102,100,202,MM3.H3K27ac_DEGREE_TABLE.txt
2971,ARID5A,97,101,198,MM3.H3K27ac_DEGREE_TABLE.txt
2972,ARX,99,103,202,MM3.H3K27ac_DEGREE_TABLE.txt
2973,ATF4,104,104,208,MM3.H3K27ac_DEGREE_TABLE.txt
2974,ATF5,99,104,203,MM3.H3K27ac_DEGREE_TABLE.txt
2975,ATF6,100,97,197,MM3.H3K27ac_DEGREE_TABLE.txt
2976,BCLAF1,88,104,192,MM3.H3K27ac_DEGREE_TABLE.txt
2977,BHLHA15,101,104,205,MM3.H3K27ac_DEGREE_TABLE.txt
2978,BHLHE41,101,92,193,MM3.H3K27ac_DEGREE_TABLE.txt
2979,CHD2,104,103,207,MM3.H3K27ac_DEGREE_TABLE.txt
2980,CREB3L2,103,103,206,MM3.H3K27ac_DEGREE_TABLE.txt
2981,CTCF,103,104,207,MM3.H3K27ac_DEGREE_TABLE.txt
2982,CTCFL,101,104,205,MM3.H3K27ac_DEGREE_TABLE.txt
2983,CUX1,104,103,207,MM3.H3K27ac_DEGREE_TABLE.txt
2984,DBP,99,104,203,MM3.H3K27ac_DEGREE_TABLE.txt
2985,DMRTC2,103,99,202,MM3.H3K27ac_DEGREE_TABLE.txt
2986,ELK3,103,97,200,MM3.H3K27ac_DEGREE_TABLE.txt
2987,ERF,97,103,200,MM3.H3K27ac_DEGREE_TABLE.txt
2988,ESR1,103,104,207,MM3.H3K27ac_DEGREE_TABLE.txt
2989,ETV6,101,104,205,MM3.H3K27ac_DEGREE_TABLE.txt
2990,ETV7,103,104,207,MM3.H3K27ac_DEGREE_TABLE.txt
2991,FIZ1,101,104,205,MM3.H3K27ac_DEGREE_TABLE.txt
2992,FLI1,104,104,208,MM3.H3K27ac_DEGREE_TABLE.txt
2993,FOXK2,103,96,199,MM3.H3K27ac_DEGREE_TABLE.txt
2994,FOXN3,103,49,152,MM3.H3K27ac_DEGREE_TABLE.txt
2995,FOXO3,100,104,204,MM3.H3K27ac_DEGREE_TABLE.txt
2996,FOXP2,94,104,198,MM3.H3K27ac_DEGREE_TABLE.txt
2997,GZF1,101,68,169,MM3.H3K27ac_DEGREE_TABLE.txt
2998,HES7,98,104,202,MM3.H3K27ac_DEGREE_TABLE.txt
2999,HEY2,101,95,196,MM3.H3K27ac_DEGREE_TABLE.txt
3000,HIVEP2,104,104,208,MM3.H3K27ac_DEGREE_TABLE.txt
3001,IKZF1,102,104,206,MM3.H3K27ac_DEGREE_TABLE.txt
3002,IKZF3,103,104,207,MM3.H3K27ac_DEGREE_TABLE.txt
3003,IRF1,104,104,208,MM3.H3K27ac_DEGREE_TABLE.txt
3004,IRF2,104,103,207,MM3.H3K27ac_DEGREE_TABLE.txt
3005,IRF4,103,104,207,MM3.H3K27ac_DEGREE_TABLE.txt
3006,ISL2,100,104,204,MM3.H3K27ac_DEGREE_TABLE.txt
3007,JUN,91,104,195,MM3.H3K27ac_DEGREE_TABLE.txt
3008,JUNB,103,104,207,MM3.H3K27ac_DEGREE_TABLE.txt
3009,JUND,97,104,201,MM3.H3K27ac_DEGREE_TABLE.txt
3010,KLF12,96,104,200,MM3.H3K27ac_DEGREE_TABLE.txt
3011,KLF13,103,101,204,MM3.H3K27ac_DEGREE_TABLE.txt
3012,KLF2,104,104,208,MM3.H3K27ac_DEGREE_TABLE.txt
3013,KLF6,95,104,199,MM3.H3K27ac_DEGREE_TABLE.txt
3014,KLF9,101,104,205,MM3.H3K27ac_DEGREE_TABLE.txt
3015,MAFF,104,104,208,MM3.H3K27ac_DEGREE_TABLE.txt
3016,MEF2C,104,104,208,MM3.H3K27ac_DEGREE_TABLE.txt
3017,MEF2D,103,103,206,MM3.H3K27ac_DEGREE_TABLE.txt
3018,MIXL1,99,96,195,MM3.H3K27ac_DEGREE_TABLE.txt
3019,MYBL2,98,94,192,MM3.H3K27ac_DEGREE_TABLE.txt
3020,NFATC2,101,104,205,MM3.H3K27ac_DEGREE_TABLE.txt
3021,NR1D1,103,104,207,MM3.H3K27ac_DEGREE_TABLE.txt
3022,NR1I3,103,100,203,MM3.H3K27ac_DEGREE_TABLE.txt
3023,NR4A2,98,104,202,MM3.H3K27ac_DEGREE_TABLE.txt
3024,PAX5,100,104,204,MM3.H3K27ac_DEGREE_TABLE.txt
3025,PBX2,98,95,193,MM3.H3K27ac_DEGREE_TABLE.txt
3026,POU2F2,100,104,204,MM3.H3K27ac_DEGREE_TABLE.txt
3027,POU5F1,103,104,207,MM3.H3K27ac_DEGREE_TABLE.txt
3028,POU5F1B,98,103,201,MM3.H3K27ac_DEGREE_TABLE.txt
3029,PPARD,102,102,204,MM3.H3K27ac_DEGREE_TABLE.txt
3030,PRDM1,104,104,208,MM3.H3K27ac_DEGREE_TABLE.txt
3031,RARA,102,104,206,MM3.H3K27ac_DEGREE_TABLE.txt
3032,RERE,102,100,202,MM3.H3K27ac_DEGREE_TABLE.txt
3033,RFX1,102,104,206,MM3.H3K27ac_DEGREE_TABLE.txt
3034,RORA,102,104,206,MM3.H3K27ac_DEGREE_TABLE.txt
3035,RREB1,104,104,208,MM3.H3K27ac_DEGREE_TABLE.txt
3036,RUNX1,101,103,204,MM3.H3K27ac_DEGREE_TABLE.txt
3037,RUNX3,99,104,203,MM3.H3K27ac_DEGREE_TABLE.txt
3038,SMAD3,104,104,208,MM3.H3K27ac_DEGREE_TABLE.txt
3039,SMAD7,103,101,204,MM3.H3K27ac_DEGREE_TABLE.txt
3040,SNAI3,101,103,204,MM3.H3K27ac_DEGREE_TABLE.txt
3041,SOX30,101,104,205,MM3.H3K27ac_DEGREE_TABLE.txt
3042,TCF3,99,104,203,MM3.H3K27ac_DEGREE_TABLE.txt
3043,TEF,98,104,202,MM3.H3K27ac_DEGREE_TABLE.txt
3044,TFEB,101,97,198,MM3.H3K27ac_DEGREE_TABLE.txt
3045,THRA,103,104,207,MM3.H3K27ac_DEGREE_TABLE.txt
3046,USF1,101,103,204,MM3.H3K27ac_DEGREE_TABLE.txt
3047,USF2,101,104,205,MM3.H3K27ac_DEGREE_TABLE.txt
3048,VSX1,103,102,205,MM3.H3K27ac_DEGREE_TABLE.txt
3049,XBP1,104,102,206,MM3.H3K27ac_DEGREE_TABLE.txt
3050,ZBED6,102,102,204,MM3.H3K27ac_DEGREE_TABLE.txt
3051,ZBTB1,99,102,201,MM3.H3K27ac_DEGREE_TABLE.txt
3052,ZBTB20,103,95,198,MM3.H3K27ac_DEGREE_TABLE.txt
3053,ZBTB38,104,100,204,MM3.H3K27ac_DEGREE_TABLE.txt
3054,ZBTB7B,103,104,207,MM3.H3K27ac_DEGREE_TABLE.txt
3055,ZFP62,103,104,207,MM3.H3K27ac_DEGREE_TABLE.txt
3056,ZNF114,100,101,201,MM3.H3K27ac_DEGREE_TABLE.txt
3057,ZNF16,98,104,202,MM3.H3K27ac_DEGREE_TABLE.txt
3058,ZNF217,104,93,197,MM3.H3K27ac_DEGREE_TABLE.txt
3059,ZNF250,98,104,202,MM3.H3K27ac_DEGREE_TABLE.txt
3060,ZNF283,101,104,205,MM3.H3K27ac_DEGREE_TABLE.txt
3061,ZNF460,100,104,204,MM3.H3K27ac_DEGREE_TABLE.txt
3062,ZNF524,101,104,205,MM3.H3K27ac_DEGREE_TABLE.txt
3063,ZNF526,97,103,200,MM3.H3K27ac_DEGREE_TABLE.txt
3064,ZNF543,100,104,204,MM3.H3K27ac_DEGREE_TABLE.txt
3065,ZNF574,100,104,204,MM3.H3K27ac_DEGREE_TABLE.txt
3066,ZNF580,101,103,204,MM3.H3K27ac_DEGREE_TABLE.txt
3067,ZNF581,101,104,205,MM3.H3K27ac_DEGREE_TABLE.txt
3068,ZNF592,100,75,175,MM3.H3K27ac_DEGREE_TABLE.txt
3069,ZNF643,102,104,206,MM3.H3K27ac_DEGREE_TABLE.txt
3070,ZNF76,102,104,206,MM3.H3K27ac_DEGREE_TABLE.txt
3071,ZNF784,101,104,205,MM3.H3K27ac_DEGREE_TABLE.txt
3072,ZNF805,100,104,204,MM3.H3K27ac_DEGREE_TABLE.txt
3073,ARF1,85,28,113,OPM-2.H3K27ac_DEGREE_TABLE.txt
3074,ATF4,71,84,155,OPM-2.H3K27ac_DEGREE_TABLE.txt
3075,ATF5,74,85,159,OPM-2.H3K27ac_DEGREE_TABLE.txt
3076,BACH2,81,84,165,OPM-2.H3K27ac_DEGREE_TABLE.txt
3077,CAMTA1,83,31,114,OPM-2.H3K27ac_DEGREE_TABLE.txt
3078,CEBPB,75,75,150,OPM-2.H3K27ac_DEGREE_TABLE.txt
3079,CREB3L2,82,71,153,OPM-2.H3K27ac_DEGREE_TABLE.txt
3080,DDIT3,84,74,158,OPM-2.H3K27ac_DEGREE_TABLE.txt
3081,E2F2,83,88,171,OPM-2.H3K27ac_DEGREE_TABLE.txt
3082,E2F3,76,93,169,OPM-2.H3K27ac_DEGREE_TABLE.txt
3083,E2F6,88,94,182,OPM-2.H3K27ac_DEGREE_TABLE.txt
3084,E4F1,64,79,143,OPM-2.H3K27ac_DEGREE_TABLE.txt
3085,EHF,80,93,173,OPM-2.H3K27ac_DEGREE_TABLE.txt
3086,ESRRA,71,94,165,OPM-2.H3K27ac_DEGREE_TABLE.txt
3087,ETV3,92,66,158,OPM-2.H3K27ac_DEGREE_TABLE.txt
3088,FLI1,86,91,177,OPM-2.H3K27ac_DEGREE_TABLE.txt
3089,FOS,73,79,152,OPM-2.H3K27ac_DEGREE_TABLE.txt
3090,FOSL1,80,65,145,OPM-2.H3K27ac_DEGREE_TABLE.txt
3091,FOXO1,81,92,173,OPM-2.H3K27ac_DEGREE_TABLE.txt
3092,FOXO3,86,94,180,OPM-2.H3K27ac_DEGREE_TABLE.txt
3093,FOXP2,70,78,148,OPM-2.H3K27ac_DEGREE_TABLE.txt
3094,GFI1,82,91,173,OPM-2.H3K27ac_DEGREE_TABLE.txt
3095,GLI1,79,92,171,OPM-2.H3K27ac_DEGREE_TABLE.txt
3096,HES7,86,92,178,OPM-2.H3K27ac_DEGREE_TABLE.txt
3097,HIVEP2,83,80,163,OPM-2.H3K27ac_DEGREE_TABLE.txt
3098,HMX1,74,65,139,OPM-2.H3K27ac_DEGREE_TABLE.txt
3099,IKZF1,90,90,180,OPM-2.H3K27ac_DEGREE_TABLE.txt
3100,IKZF3,85,92,177,OPM-2.H3K27ac_DEGREE_TABLE.txt
3101,IRF2,93,79,172,OPM-2.H3K27ac_DEGREE_TABLE.txt
3102,IRF3,82,89,171,OPM-2.H3K27ac_DEGREE_TABLE.txt
3103,IRF4,89,84,173,OPM-2.H3K27ac_DEGREE_TABLE.txt
3104,JUN,67,84,151,OPM-2.H3K27ac_DEGREE_TABLE.txt
3105,JUNB,87,87,174,OPM-2.H3K27ac_DEGREE_TABLE.txt
3106,JUND,71,93,164,OPM-2.H3K27ac_DEGREE_TABLE.txt
3107,KLF13,90,70,160,OPM-2.H3K27ac_DEGREE_TABLE.txt
3108,KLF2,88,94,182,OPM-2.H3K27ac_DEGREE_TABLE.txt
3109,KLF6,93,86,179,OPM-2.H3K27ac_DEGREE_TABLE.txt
3110,KLF9,79,92,171,OPM-2.H3K27ac_DEGREE_TABLE.txt
3111,LHX3,86,77,163,OPM-2.H3K27ac_DEGREE_TABLE.txt
3112,MAFB,79,93,172,OPM-2.H3K27ac_DEGREE_TABLE.txt
3113,MAX,84,91,175,OPM-2.H3K27ac_DEGREE_TABLE.txt
3114,MAZ,80,94,174,OPM-2.H3K27ac_DEGREE_TABLE.txt
3115,MEF2C,92,87,179,OPM-2.H3K27ac_DEGREE_TABLE.txt
3116,MEF2D,91,83,174,OPM-2.H3K27ac_DEGREE_TABLE.txt
3117,MNT,85,47,132,OPM-2.H3K27ac_DEGREE_TABLE.txt
3118,MYBL2,77,66,143,OPM-2.H3K27ac_DEGREE_TABLE.txt
3119,MYC,91,78,169,OPM-2.H3K27ac_DEGREE_TABLE.txt
3120,NFE2,64,57,121,OPM-2.H3K27ac_DEGREE_TABLE.txt
3121,NFE2L2,74,76,150,OPM-2.H3K27ac_DEGREE_TABLE.txt
3122,NFE2L3,79,86,165,OPM-2.H3K27ac_DEGREE_TABLE.txt
3123,NFIC,77,91,168,OPM-2.H3K27ac_DEGREE_TABLE.txt
3124,NFIL3,87,60,147,OPM-2.H3K27ac_DEGREE_TABLE.txt
3125,NR3C1,74,84,158,OPM-2.H3K27ac_DEGREE_TABLE.txt
3126,OLIG1,82,34,116,OPM-2.H3K27ac_DEGREE_TABLE.txt
3127,OLIG2,82,78,160,OPM-2.H3K27ac_DEGREE_TABLE.txt
3128,POU2F1,76,92,168,OPM-2.H3K27ac_DEGREE_TABLE.txt
3129,PRDM1,93,91,184,OPM-2.H3K27ac_DEGREE_TABLE.txt
3130,PRDM10,67,59,126,OPM-2.H3K27ac_DEGREE_TABLE.txt
3131,RARA,91,94,185,OPM-2.H3K27ac_DEGREE_TABLE.txt
3132,RARG,86,94,180,OPM-2.H3K27ac_DEGREE_TABLE.txt
3133,RFX1,60,93,153,OPM-2.H3K27ac_DEGREE_TABLE.txt
3134,RFX3,78,89,167,OPM-2.H3K27ac_DEGREE_TABLE.txt
3135,RUNX1,92,74,166,OPM-2.H3K27ac_DEGREE_TABLE.txt
3136,RUNX2,93,86,179,OPM-2.H3K27ac_DEGREE_TABLE.txt
3137,RUNX3,72,89,161,OPM-2.H3K27ac_DEGREE_TABLE.txt
3138,SIN3A,80,94,174,OPM-2.H3K27ac_DEGREE_TABLE.txt
3139,SOX11,82,93,175,OPM-2.H3K27ac_DEGREE_TABLE.txt
3140,SP3,56,94,150,OPM-2.H3K27ac_DEGREE_TABLE.txt
3141,SREBF1,86,84,170,OPM-2.H3K27ac_DEGREE_TABLE.txt
3142,TBX2,76,87,163,OPM-2.H3K27ac_DEGREE_TABLE.txt
3143,TBX6,79,66,145,OPM-2.H3K27ac_DEGREE_TABLE.txt
3144,TGIF1,79,74,153,OPM-2.H3K27ac_DEGREE_TABLE.txt
3145,THAP1,91,94,185,OPM-2.H3K27ac_DEGREE_TABLE.txt
3146,XBP1,93,56,149,OPM-2.H3K27ac_DEGREE_TABLE.txt
3147,ZBTB1,75,61,136,OPM-2.H3K27ac_DEGREE_TABLE.txt
3148,ZBTB38,93,73,166,OPM-2.H3K27ac_DEGREE_TABLE.txt
3149,ZBTB7B,90,89,179,OPM-2.H3K27ac_DEGREE_TABLE.txt
3150,ZFP91,83,79,162,OPM-2.H3K27ac_DEGREE_TABLE.txt
3151,ZNF217,87,49,136,OPM-2.H3K27ac_DEGREE_TABLE.txt
3152,ZNF335,67,87,154,OPM-2.H3K27ac_DEGREE_TABLE.txt
3153,ZNF490,82,77,159,OPM-2.H3K27ac_DEGREE_TABLE.txt
3154,ZNF580,69,86,155,OPM-2.H3K27ac_DEGREE_TABLE.txt
3155,ZNF581,69,78,147,OPM-2.H3K27ac_DEGREE_TABLE.txt
3156,ZNF595,84,93,177,OPM-2.H3K27ac_DEGREE_TABLE.txt
3157,ZNF672,77,91,168,OPM-2.H3K27ac_DEGREE_TABLE.txt
3158,ZNF687,66,48,114,OPM-2.H3K27ac_DEGREE_TABLE.txt
3159,ZNF689,66,83,149,OPM-2.H3K27ac_DEGREE_TABLE.txt
3160,ZNF692,77,91,168,OPM-2.H3K27ac_DEGREE_TABLE.txt
3161,ZNF718,84,93,177,OPM-2.H3K27ac_DEGREE_TABLE.txt
3162,ZNF740,86,94,180,OPM-2.H3K27ac_DEGREE_TABLE.txt
3163,ZNF775,88,84,172,OPM-2.H3K27ac_DEGREE_TABLE.txt
3164,ZNF784,69,85,154,OPM-2.H3K27ac_DEGREE_TABLE.txt
3165,ZNF791,82,76,158,OPM-2.H3K27ac_DEGREE_TABLE.txt
3166,ZXDA,92,83,175,OPM-2.H3K27ac_DEGREE_TABLE.txt
3167,ARF1,26,13,39,MOLP-8.H3K27ac_DEGREE_TABLE.txt
3168,ATF4,24,32,56,MOLP-8.H3K27ac_DEGREE_TABLE.txt
3169,BACH2,31,26,57,MOLP-8.H3K27ac_DEGREE_TABLE.txt
3170,E2F2,29,31,60,MOLP-8.H3K27ac_DEGREE_TABLE.txt
3171,E2F3,25,33,58,MOLP-8.H3K27ac_DEGREE_TABLE.txt
3172,ESR1,25,34,59,MOLP-8.H3K27ac_DEGREE_TABLE.txt
3173,FOSB,31,13,44,MOLP-8.H3K27ac_DEGREE_TABLE.txt
3174,FOSL1,31,19,50,MOLP-8.H3K27ac_DEGREE_TABLE.txt
3175,FOXO1,27,33,60,MOLP-8.H3K27ac_DEGREE_TABLE.txt
3176,FOXO3,29,34,63,MOLP-8.H3K27ac_DEGREE_TABLE.txt
3177,HIVEP2,29,28,57,MOLP-8.H3K27ac_DEGREE_TABLE.txt
3178,IRF2,29,28,57,MOLP-8.H3K27ac_DEGREE_TABLE.txt
3179,IRF4,30,28,58,MOLP-8.H3K27ac_DEGREE_TABLE.txt
3180,ISX,25,31,56,MOLP-8.H3K27ac_DEGREE_TABLE.txt
3181,JUNB,31,28,59,MOLP-8.H3K27ac_DEGREE_TABLE.txt
3182,JUND,19,34,53,MOLP-8.H3K27ac_DEGREE_TABLE.txt
3183,KLF2,27,31,58,MOLP-8.H3K27ac_DEGREE_TABLE.txt
3184,KLF6,32,24,56,MOLP-8.H3K27ac_DEGREE_TABLE.txt
3185,KLF9,29,33,62,MOLP-8.H3K27ac_DEGREE_TABLE.txt
3186,MEF2D,31,28,59,MOLP-8.H3K27ac_DEGREE_TABLE.txt
3187,MNT,26,19,45,MOLP-8.H3K27ac_DEGREE_TABLE.txt
3188,NR3C1,29,29,58,MOLP-8.H3K27ac_DEGREE_TABLE.txt
3189,POU2F1,27,34,61,MOLP-8.H3K27ac_DEGREE_TABLE.txt
3190,PRDM1,27,33,60,MOLP-8.H3K27ac_DEGREE_TABLE.txt
3191,RFX3,23,29,52,MOLP-8.H3K27ac_DEGREE_TABLE.txt
3192,RUNX2,29,31,60,MOLP-8.H3K27ac_DEGREE_TABLE.txt
3193,SP3,20,33,53,MOLP-8.H3K27ac_DEGREE_TABLE.txt
3194,SRF,27,34,61,MOLP-8.H3K27ac_DEGREE_TABLE.txt
3195,TCFL5,23,22,45,MOLP-8.H3K27ac_DEGREE_TABLE.txt
3196,XBP1,34,21,55,MOLP-8.H3K27ac_DEGREE_TABLE.txt
3197,ZBTB1,24,21,45,MOLP-8.H3K27ac_DEGREE_TABLE.txt
3198,ZBTB38,30,24,54,MOLP-8.H3K27ac_DEGREE_TABLE.txt
3199,ZBTB7B,33,27,60,MOLP-8.H3K27ac_DEGREE_TABLE.txt
3200,ZNF687,25,19,44,MOLP-8.H3K27ac_DEGREE_TABLE.txt
3201,ARF1,110,26,136,MM2.H3K27ac_DEGREE_TABLE.txt
3202,ARF4,104,50,154,MM2.H3K27ac_DEGREE_TABLE.txt
3203,ARID5A,77,96,173,MM2.H3K27ac_DEGREE_TABLE.txt
3204,ATF3,108,125,233,MM2.H3K27ac_DEGREE_TABLE.txt
3205,BACH1,100,76,176,MM2.H3K27ac_DEGREE_TABLE.txt
3206,BACH2,85,92,177,MM2.H3K27ac_DEGREE_TABLE.txt
3207,BCL6B,101,121,222,MM2.H3K27ac_DEGREE_TABLE.txt
3208,BCLAF1,91,122,213,MM2.H3K27ac_DEGREE_TABLE.txt
3209,BHLHE40,107,65,172,MM2.H3K27ac_DEGREE_TABLE.txt
3210,BHLHE41,120,44,164,MM2.H3K27ac_DEGREE_TABLE.txt
3211,CAMTA2,106,21,127,MM2.H3K27ac_DEGREE_TABLE.txt
3212,CEBPB,101,83,184,MM2.H3K27ac_DEGREE_TABLE.txt
3213,CEBPG,85,93,178,MM2.H3K27ac_DEGREE_TABLE.txt
3214,CHD2,119,116,235,MM2.H3K27ac_DEGREE_TABLE.txt
3215,CREB1,95,102,197,MM2.H3K27ac_DEGREE_TABLE.txt
3216,CREB3L2,117,82,199,MM2.H3K27ac_DEGREE_TABLE.txt
3217,CREM,97,79,176,MM2.H3K27ac_DEGREE_TABLE.txt
3218,DBP,105,103,208,MM2.H3K27ac_DEGREE_TABLE.txt
3219,DDIT3,112,85,197,MM2.H3K27ac_DEGREE_TABLE.txt
3220,DEAF1,77,99,176,MM2.H3K27ac_DEGREE_TABLE.txt
3221,E2F2,100,101,201,MM2.H3K27ac_DEGREE_TABLE.txt
3222,ELF2,86,95,181,MM2.H3K27ac_DEGREE_TABLE.txt
3223,ELK3,98,77,175,MM2.H3K27ac_DEGREE_TABLE.txt
3224,ELK4,82,98,180,MM2.H3K27ac_DEGREE_TABLE.txt
3225,ERF,110,90,200,MM2.H3K27ac_DEGREE_TABLE.txt
3226,ESR1,87,122,209,MM2.H3K27ac_DEGREE_TABLE.txt
3227,ETV6,92,109,201,MM2.H3K27ac_DEGREE_TABLE.txt
3228,FLI1,115,121,236,MM2.H3K27ac_DEGREE_TABLE.txt
3229,FOS,91,99,190,MM2.H3K27ac_DEGREE_TABLE.txt
3230,FOSL2,104,79,183,MM2.H3K27ac_DEGREE_TABLE.txt
3231,FOXO3,102,121,223,MM2.H3K27ac_DEGREE_TABLE.txt
3232,FOXP2,96,105,201,MM2.H3K27ac_DEGREE_TABLE.txt
3233,HAP1,90,8,98,MM2.H3K27ac_DEGREE_TABLE.txt
3234,HBP1,99,112,211,MM2.H3K27ac_DEGREE_TABLE.txt
3235,HES7,92,112,204,MM2.H3K27ac_DEGREE_TABLE.txt
3236,HEY1,93,45,138,MM2.H3K27ac_DEGREE_TABLE.txt
3237,HIVEP2,119,92,211,MM2.H3K27ac_DEGREE_TABLE.txt
3238,IKZF1,112,116,228,MM2.H3K27ac_DEGREE_TABLE.txt
3239,IKZF3,103,124,227,MM2.H3K27ac_DEGREE_TABLE.txt
3240,IRF1,123,120,243,MM2.H3K27ac_DEGREE_TABLE.txt
3241,IRF2,117,86,203,MM2.H3K27ac_DEGREE_TABLE.txt
3242,IRF3,98,118,216,MM2.H3K27ac_DEGREE_TABLE.txt
3243,IRF4,111,105,216,MM2.H3K27ac_DEGREE_TABLE.txt
3244,JUN,96,100,196,MM2.H3K27ac_DEGREE_TABLE.txt
3245,JUNB,113,105,218,MM2.H3K27ac_DEGREE_TABLE.txt
3246,JUND,89,124,213,MM2.H3K27ac_DEGREE_TABLE.txt
3247,KLF13,123,71,194,MM2.H3K27ac_DEGREE_TABLE.txt
3248,KLF15,72,124,196,MM2.H3K27ac_DEGREE_TABLE.txt
3249,KLF2,102,112,214,MM2.H3K27ac_DEGREE_TABLE.txt
3250,KLF3,102,113,215,MM2.H3K27ac_DEGREE_TABLE.txt
3251,KLF6,111,99,210,MM2.H3K27ac_DEGREE_TABLE.txt
3252,KLF7,75,124,199,MM2.H3K27ac_DEGREE_TABLE.txt
3253,KLF9,115,111,226,MM2.H3K27ac_DEGREE_TABLE.txt
3254,MEF2A,95,117,212,MM2.H3K27ac_DEGREE_TABLE.txt
3255,MEF2C,113,111,224,MM2.H3K27ac_DEGREE_TABLE.txt
3256,MEF2D,119,100,219,MM2.H3K27ac_DEGREE_TABLE.txt
3257,MIXL1,96,81,177,MM2.H3K27ac_DEGREE_TABLE.txt
3258,MXI1,102,93,195,MM2.H3K27ac_DEGREE_TABLE.txt
3259,MYBL2,77,78,155,MM2.H3K27ac_DEGREE_TABLE.txt
3260,MYC,108,79,187,MM2.H3K27ac_DEGREE_TABLE.txt
3261,MYNN,91,69,160,MM2.H3K27ac_DEGREE_TABLE.txt
3262,MZF1,87,123,210,MM2.H3K27ac_DEGREE_TABLE.txt
3263,NFE2L2,109,77,186,MM2.H3K27ac_DEGREE_TABLE.txt
3264,NFE2L3,103,107,210,MM2.H3K27ac_DEGREE_TABLE.txt
3265,NFKB1,86,119,205,MM2.H3K27ac_DEGREE_TABLE.txt
3266,NFKB2,80,98,178,MM2.H3K27ac_DEGREE_TABLE.txt
3267,NFYA,87,78,165,MM2.H3K27ac_DEGREE_TABLE.txt
3268,NHLH1,96,96,192,MM2.H3K27ac_DEGREE_TABLE.txt
3269,NR1D1,105,110,215,MM2.H3K27ac_DEGREE_TABLE.txt
3270,NR1D2,95,68,163,MM2.H3K27ac_DEGREE_TABLE.txt
3271,NR3C1,94,99,193,MM2.H3K27ac_DEGREE_TABLE.txt
3272,NR4A2,104,110,214,MM2.H3K27ac_DEGREE_TABLE.txt
3273,PBX2,96,73,169,MM2.H3K27ac_DEGREE_TABLE.txt
3274,PLAGL2,103,125,228,MM2.H3K27ac_DEGREE_TABLE.txt
3275,POU2F1,97,120,217,MM2.H3K27ac_DEGREE_TABLE.txt
3276,POU5F1,88,119,207,MM2.H3K27ac_DEGREE_TABLE.txt
3277,POU6F1,78,111,189,MM2.H3K27ac_DEGREE_TABLE.txt
3278,PRDM1,123,122,245,MM2.H3K27ac_DEGREE_TABLE.txt
3279,PRDM10,80,67,147,MM2.H3K27ac_DEGREE_TABLE.txt
3280,RFX1,82,117,199,MM2.H3K27ac_DEGREE_TABLE.txt
3281,RFX3,106,105,211,MM2.H3K27ac_DEGREE_TABLE.txt
3282,RUNX1,110,82,192,MM2.H3K27ac_DEGREE_TABLE.txt
3283,RXRB,84,107,191,MM2.H3K27ac_DEGREE_TABLE.txt
3284,SIN3A,99,125,224,MM2.H3K27ac_DEGREE_TABLE.txt
3285,SMAD4,67,109,176,MM2.H3K27ac_DEGREE_TABLE.txt
3286,SP3,79,124,203,MM2.H3K27ac_DEGREE_TABLE.txt
3287,SREBF2,97,90,187,MM2.H3K27ac_DEGREE_TABLE.txt
3288,TBX6,100,81,181,MM2.H3K27ac_DEGREE_TABLE.txt
3289,TCF12,81,113,194,MM2.H3K27ac_DEGREE_TABLE.txt
3290,TCF3,112,125,237,MM2.H3K27ac_DEGREE_TABLE.txt
3291,TCF4,117,99,216,MM2.H3K27ac_DEGREE_TABLE.txt
3292,THRA,105,112,217,MM2.H3K27ac_DEGREE_TABLE.txt
3293,TP53,96,96,192,MM2.H3K27ac_DEGREE_TABLE.txt
3294,USF1,114,87,201,MM2.H3K27ac_DEGREE_TABLE.txt
3295,XBP1,118,74,192,MM2.H3K27ac_DEGREE_TABLE.txt
3296,ZBED6,105,87,192,MM2.H3K27ac_DEGREE_TABLE.txt
3297,ZBTB1,92,63,155,MM2.H3K27ac_DEGREE_TABLE.txt
3298,ZBTB11,105,124,229,MM2.H3K27ac_DEGREE_TABLE.txt
3299,ZBTB20,88,72,160,MM2.H3K27ac_DEGREE_TABLE.txt
3300,ZBTB38,123,75,198,MM2.H3K27ac_DEGREE_TABLE.txt
3301,ZBTB7B,114,112,226,MM2.H3K27ac_DEGREE_TABLE.txt
3302,ZFP91,101,95,196,MM2.H3K27ac_DEGREE_TABLE.txt
3303,ZFX,87,125,212,MM2.H3K27ac_DEGREE_TABLE.txt
3304,ZNF124,103,105,208,MM2.H3K27ac_DEGREE_TABLE.txt
3305,ZNF143,83,111,194,MM2.H3K27ac_DEGREE_TABLE.txt
3306,ZNF215,85,92,177,MM2.H3K27ac_DEGREE_TABLE.txt
3307,ZNF217,113,65,178,MM2.H3K27ac_DEGREE_TABLE.txt
3308,ZNF274,62,80,142,MM2.H3K27ac_DEGREE_TABLE.txt
3309,ZNF280D,78,53,131,MM2.H3K27ac_DEGREE_TABLE.txt
3310,ZNF329,62,108,170,MM2.H3K27ac_DEGREE_TABLE.txt
3311,ZNF460,89,125,214,MM2.H3K27ac_DEGREE_TABLE.txt
3312,ZNF483,77,110,187,MM2.H3K27ac_DEGREE_TABLE.txt
3313,ZNF526,110,115,225,MM2.H3K27ac_DEGREE_TABLE.txt
3314,ZNF543,89,116,205,MM2.H3K27ac_DEGREE_TABLE.txt
3315,ZNF544,62,117,179,MM2.H3K27ac_DEGREE_TABLE.txt
3316,ZNF580,94,119,213,MM2.H3K27ac_DEGREE_TABLE.txt
3317,ZNF581,94,97,191,MM2.H3K27ac_DEGREE_TABLE.txt
3318,ZNF592,82,43,125,MM2.H3K27ac_DEGREE_TABLE.txt
3319,ZNF655,70,118,188,MM2.H3K27ac_DEGREE_TABLE.txt
3320,ZNF672,107,117,224,MM2.H3K27ac_DEGREE_TABLE.txt
3321,ZNF687,87,52,139,MM2.H3K27ac_DEGREE_TABLE.txt
3322,ZNF689,64,100,164,MM2.H3K27ac_DEGREE_TABLE.txt
3323,ZNF692,107,109,216,MM2.H3K27ac_DEGREE_TABLE.txt
3324,ZNF784,94,102,196,MM2.H3K27ac_DEGREE_TABLE.txt
3325,ZNF805,89,109,198,MM2.H3K27ac_DEGREE_TABLE.txt
3326,AIRE,37,36,73,KMS-12-BM.H3K27ac_DEGREE_TABLE.txt
3327,BATF,39,34,73,KMS-12-BM.H3K27ac_DEGREE_TABLE.txt
3328,BHLHE41,40,25,65,KMS-12-BM.H3K27ac_DEGREE_TABLE.txt
3329,CEBPD,38,33,71,KMS-12-BM.H3K27ac_DEGREE_TABLE.txt
3330,CREB3L2,40,33,73,KMS-12-BM.H3K27ac_DEGREE_TABLE.txt
3331,DDIT3,33,36,69,KMS-12-BM.H3K27ac_DEGREE_TABLE.txt
3332,ETS1,37,41,78,KMS-12-BM.H3K27ac_DEGREE_TABLE.txt
3333,ETV6,40,41,81,KMS-12-BM.H3K27ac_DEGREE_TABLE.txt
3334,FLI1,40,41,81,KMS-12-BM.H3K27ac_DEGREE_TABLE.txt
3335,FOSL1,36,33,69,KMS-12-BM.H3K27ac_DEGREE_TABLE.txt
3336,FOXH1,27,40,67,KMS-12-BM.H3K27ac_DEGREE_TABLE.txt
3337,FOXO3,30,41,71,KMS-12-BM.H3K27ac_DEGREE_TABLE.txt
3338,HBP1,34,37,71,KMS-12-BM.H3K27ac_DEGREE_TABLE.txt
3339,HES1,41,39,80,KMS-12-BM.H3K27ac_DEGREE_TABLE.txt
3340,HIVEP2,36,38,74,KMS-12-BM.H3K27ac_DEGREE_TABLE.txt
3341,IKZF1,39,38,77,KMS-12-BM.H3K27ac_DEGREE_TABLE.txt
3342,IRF4,40,40,80,KMS-12-BM.H3K27ac_DEGREE_TABLE.txt
3343,JUNB,37,38,75,KMS-12-BM.H3K27ac_DEGREE_TABLE.txt
3344,KLF13,38,31,69,KMS-12-BM.H3K27ac_DEGREE_TABLE.txt
3345,KLF2,38,41,79,KMS-12-BM.H3K27ac_DEGREE_TABLE.txt
3346,MEF2D,38,39,77,KMS-12-BM.H3K27ac_DEGREE_TABLE.txt
3347,MYBL2,39,34,73,KMS-12-BM.H3K27ac_DEGREE_TABLE.txt
3348,NFE2L3,40,40,80,KMS-12-BM.H3K27ac_DEGREE_TABLE.txt
3349,NFKB2,31,40,71,KMS-12-BM.H3K27ac_DEGREE_TABLE.txt
3350,OVOL1,34,34,68,KMS-12-BM.H3K27ac_DEGREE_TABLE.txt
3351,PRDM1,39,39,78,KMS-12-BM.H3K27ac_DEGREE_TABLE.txt
3352,PRDM10,31,30,61,KMS-12-BM.H3K27ac_DEGREE_TABLE.txt
3353,RELA,30,41,71,KMS-12-BM.H3K27ac_DEGREE_TABLE.txt
3354,RREB1,37,41,78,KMS-12-BM.H3K27ac_DEGREE_TABLE.txt
3355,RUNX2,37,41,78,KMS-12-BM.H3K27ac_DEGREE_TABLE.txt
3356,SIN3A,36,41,77,KMS-12-BM.H3K27ac_DEGREE_TABLE.txt
3357,ZBTB1,37,30,67,KMS-12-BM.H3K27ac_DEGREE_TABLE.txt
3358,ZBTB38,38,37,75,KMS-12-BM.H3K27ac_DEGREE_TABLE.txt
3359,ZFP91,37,39,76,KMS-12-BM.H3K27ac_DEGREE_TABLE.txt
3360,ZNF16,32,39,71,KMS-12-BM.H3K27ac_DEGREE_TABLE.txt
3361,ZNF217,41,26,67,KMS-12-BM.H3K27ac_DEGREE_TABLE.txt
3362,ZNF250,37,41,78,KMS-12-BM.H3K27ac_DEGREE_TABLE.txt
3363,ZNF434,37,11,48,KMS-12-BM.H3K27ac_DEGREE_TABLE.txt
3364,ZNF652,32,41,73,KMS-12-BM.H3K27ac_DEGREE_TABLE.txt
3365,ZNF75A,37,41,78,KMS-12-BM.H3K27ac_DEGREE_TABLE.txt
3366,ZNF775,41,40,81,KMS-12-BM.H3K27ac_DEGREE_TABLE.txt
3367,ARF1,145,62,207,H929_H3K27ac_DEGREE_TABLE.txt
3368,ARF4,142,107,249,H929_H3K27ac_DEGREE_TABLE.txt
3369,ARID3A,130,139,269,H929_H3K27ac_DEGREE_TABLE.txt
3370,ARNT,147,105,252,H929_H3K27ac_DEGREE_TABLE.txt
3371,ATF4,145,147,292,H929_H3K27ac_DEGREE_TABLE.txt
3372,ATF5,149,149,298,H929_H3K27ac_DEGREE_TABLE.txt
3373,BCL6B,144,153,297,H929_H3K27ac_DEGREE_TABLE.txt
3374,BHLHE40,139,131,270,H929_H3K27ac_DEGREE_TABLE.txt
3375,CAMTA2,148,51,199,H929_H3K27ac_DEGREE_TABLE.txt
3376,CEBPB,130,137,267,H929_H3K27ac_DEGREE_TABLE.txt
3377,CHD2,146,149,295,H929_H3K27ac_DEGREE_TABLE.txt
3378,CREB3L2,150,141,291,H929_H3K27ac_DEGREE_TABLE.txt
3379,CREB3L4,152,125,277,H929_H3K27ac_DEGREE_TABLE.txt
3380,CST6,147,65,212,H929_H3K27ac_DEGREE_TABLE.txt
3381,CTCF,139,153,292,H929_H3K27ac_DEGREE_TABLE.txt
3382,CTCFL,144,153,297,H929_H3K27ac_DEGREE_TABLE.txt
3383,CTF1,129,137,266,H929_H3K27ac_DEGREE_TABLE.txt
3384,CUX1,146,123,269,H929_H3K27ac_DEGREE_TABLE.txt
3385,DBP,141,142,283,H929_H3K27ac_DEGREE_TABLE.txt
3386,DDIT3,134,147,281,H929_H3K27ac_DEGREE_TABLE.txt
3387,DMRTC2,144,116,260,H929_H3K27ac_DEGREE_TABLE.txt
3388,DUX4,100,138,238,H929_H3K27ac_DEGREE_TABLE.txt
3389,E2F1,139,145,284,H929_H3K27ac_DEGREE_TABLE.txt
3390,E2F2,142,151,293,H929_H3K27ac_DEGREE_TABLE.txt
3391,E2F3,147,152,299,H929_H3K27ac_DEGREE_TABLE.txt
3392,E2F4,150,146,296,H929_H3K27ac_DEGREE_TABLE.txt
3393,E2F6,138,152,290,H929_H3K27ac_DEGREE_TABLE.txt
3394,ELF1,148,152,300,H929_H3K27ac_DEGREE_TABLE.txt
3395,ETV3,152,127,279,H929_H3K27ac_DEGREE_TABLE.txt
3396,FIZ1,146,152,298,H929_H3K27ac_DEGREE_TABLE.txt
3397,FLI1,150,153,303,H929_H3K27ac_DEGREE_TABLE.txt
3398,FOSB,137,83,220,H929_H3K27ac_DEGREE_TABLE.txt
3399,FOSL1,152,129,281,H929_H3K27ac_DEGREE_TABLE.txt
3400,FOSL2,132,133,265,H929_H3K27ac_DEGREE_TABLE.txt
3401,FOXH1,137,140,277,H929_H3K27ac_DEGREE_TABLE.txt
3402,FOXJ1,149,151,300,H929_H3K27ac_DEGREE_TABLE.txt
3403,FOXO3,143,153,296,H929_H3K27ac_DEGREE_TABLE.txt
3404,FOXR1,149,148,297,H929_H3K27ac_DEGREE_TABLE.txt
3405,GFI1,141,151,292,H929_H3K27ac_DEGREE_TABLE.txt
3406,GLI1,142,151,293,H929_H3K27ac_DEGREE_TABLE.txt
3407,GMEB2,130,100,230,H929_H3K27ac_DEGREE_TABLE.txt
3408,HES5,143,125,268,H929_H3K27ac_DEGREE_TABLE.txt
3409,HES7,142,153,295,H929_H3K27ac_DEGREE_TABLE.txt
3410,HINFP,147,148,295,H929_H3K27ac_DEGREE_TABLE.txt
3411,ID1,140,150,290,H929_H3K27ac_DEGREE_TABLE.txt
3412,IKZF1,143,152,295,H929_H3K27ac_DEGREE_TABLE.txt
3413,IKZF3,148,153,301,H929_H3K27ac_DEGREE_TABLE.txt
3414,IRF1,152,153,305,H929_H3K27ac_DEGREE_TABLE.txt
3415,IRF2,153,137,290,H929_H3K27ac_DEGREE_TABLE.txt
3416,IRF3,145,152,297,H929_H3K27ac_DEGREE_TABLE.txt
3417,IRF4,149,149,298,H929_H3K27ac_DEGREE_TABLE.txt
3418,IRF5,135,142,277,H929_H3K27ac_DEGREE_TABLE.txt
3419,IRF6,137,145,282,H929_H3K27ac_DEGREE_TABLE.txt
3420,IRF7,134,151,285,H929_H3K27ac_DEGREE_TABLE.txt
3421,IRF9,145,148,293,H929_H3K27ac_DEGREE_TABLE.txt
3422,JUNB,150,138,288,H929_H3K27ac_DEGREE_TABLE.txt
3423,KLF1,147,153,300,H929_H3K27ac_DEGREE_TABLE.txt
3424,KLF10,142,153,295,H929_H3K27ac_DEGREE_TABLE.txt
3425,KLF13,152,138,290,H929_H3K27ac_DEGREE_TABLE.txt
3426,KLF16,136,152,288,H929_H3K27ac_DEGREE_TABLE.txt
3427,KLF9,142,152,294,H929_H3K27ac_DEGREE_TABLE.txt
3428,LHX3,139,145,284,H929_H3K27ac_DEGREE_TABLE.txt
3429,MAF,137,153,290,H929_H3K27ac_DEGREE_TABLE.txt
3430,MAFF,152,153,305,H929_H3K27ac_DEGREE_TABLE.txt
3431,MAZ,148,153,301,H929_H3K27ac_DEGREE_TABLE.txt
3432,MEF2C,150,150,300,H929_H3K27ac_DEGREE_TABLE.txt
3433,MEF2D,151,149,300,H929_H3K27ac_DEGREE_TABLE.txt
3434,MLX,152,96,248,H929_H3K27ac_DEGREE_TABLE.txt
3435,MLXIP,140,103,243,H929_H3K27ac_DEGREE_TABLE.txt
3436,MXI1,138,147,285,H929_H3K27ac_DEGREE_TABLE.txt
3437,MYBL2,140,115,255,H929_H3K27ac_DEGREE_TABLE.txt
3438,MYC,139,140,279,H929_H3K27ac_DEGREE_TABLE.txt
3439,NFATC2,145,148,293,H929_H3K27ac_DEGREE_TABLE.txt
3440,NFE2L1,144,136,280,H929_H3K27ac_DEGREE_TABLE.txt
3441,NFE2L2,136,136,272,H929_H3K27ac_DEGREE_TABLE.txt
3442,NFE2L3,145,149,294,H929_H3K27ac_DEGREE_TABLE.txt
3443,NFIC,123,150,273,H929_H3K27ac_DEGREE_TABLE.txt
3444,NFIL3,148,126,274,H929_H3K27ac_DEGREE_TABLE.txt
3445,NFIX,147,151,298,H929_H3K27ac_DEGREE_TABLE.txt
3446,NHLH1,119,147,266,H929_H3K27ac_DEGREE_TABLE.txt
3447,NR1D1,119,153,272,H929_H3K27ac_DEGREE_TABLE.txt
3448,NR1I3,150,110,260,H929_H3K27ac_DEGREE_TABLE.txt
3449,NR3C1,144,151,295,H929_H3K27ac_DEGREE_TABLE.txt
3450,PBX1,135,137,272,H929_H3K27ac_DEGREE_TABLE.txt
3451,PHOX2A,117,119,236,H929_H3K27ac_DEGREE_TABLE.txt
3452,PLAGL2,132,153,285,H929_H3K27ac_DEGREE_TABLE.txt
3453,POU2F1,128,152,280,H929_H3K27ac_DEGREE_TABLE.txt
3454,PPARD,138,143,281,H929_H3K27ac_DEGREE_TABLE.txt
3455,PRDM1,153,151,304,H929_H3K27ac_DEGREE_TABLE.txt
3456,PRDM10,115,125,240,H929_H3K27ac_DEGREE_TABLE.txt
3457,RARA,148,153,301,H929_H3K27ac_DEGREE_TABLE.txt
3458,RARG,151,153,304,H929_H3K27ac_DEGREE_TABLE.txt
3459,RUNX1,152,143,295,H929_H3K27ac_DEGREE_TABLE.txt
3460,RUNX2,152,152,304,H929_H3K27ac_DEGREE_TABLE.txt
3461,RXRA,137,153,290,H929_H3K27ac_DEGREE_TABLE.txt
3462,RXRB,138,153,291,H929_H3K27ac_DEGREE_TABLE.txt
3463,SIN3A,136,153,289,H929_H3K27ac_DEGREE_TABLE.txt
3464,SMAD7,153,143,296,H929_H3K27ac_DEGREE_TABLE.txt
3465,SNAPC4,144,126,270,H929_H3K27ac_DEGREE_TABLE.txt
3466,SOX11,140,152,292,H929_H3K27ac_DEGREE_TABLE.txt
3467,SOX15,148,153,301,H929_H3K27ac_DEGREE_TABLE.txt
3468,SOX4,137,153,290,H929_H3K27ac_DEGREE_TABLE.txt
3469,SP1,140,153,293,H929_H3K27ac_DEGREE_TABLE.txt
3470,SP3,120,153,273,H929_H3K27ac_DEGREE_TABLE.txt
3471,SREBF1,151,149,300,H929_H3K27ac_DEGREE_TABLE.txt
3472,TBX6,124,138,262,H929_H3K27ac_DEGREE_TABLE.txt
3473,TCF3,135,153,288,H929_H3K27ac_DEGREE_TABLE.txt
3474,TFAP2A,134,153,287,H929_H3K27ac_DEGREE_TABLE.txt
3475,THAP1,148,153,301,H929_H3K27ac_DEGREE_TABLE.txt
3476,USF1,144,145,289,H929_H3K27ac_DEGREE_TABLE.txt
3477,XBP1,151,127,278,H929_H3K27ac_DEGREE_TABLE.txt
3478,ZBED6,136,138,274,H929_H3K27ac_DEGREE_TABLE.txt
3479,ZBTB11,150,152,302,H929_H3K27ac_DEGREE_TABLE.txt
3480,ZBTB24,141,153,294,H929_H3K27ac_DEGREE_TABLE.txt
3481,ZBTB3,128,152,280,H929_H3K27ac_DEGREE_TABLE.txt
3482,ZBTB32,139,118,257,H929_H3K27ac_DEGREE_TABLE.txt
3483,ZBTB38,152,145,297,H929_H3K27ac_DEGREE_TABLE.txt
3484,ZBTB7A,123,151,274,H929_H3K27ac_DEGREE_TABLE.txt
3485,ZBTB7B,153,149,302,H929_H3K27ac_DEGREE_TABLE.txt
3486,ZFP1,136,152,288,H929_H3K27ac_DEGREE_TABLE.txt
3487,ZFP62,148,153,301,H929_H3K27ac_DEGREE_TABLE.txt
3488,ZFPM1,117,131,248,H929_H3K27ac_DEGREE_TABLE.txt
3489,ZNF114,142,116,258,H929_H3K27ac_DEGREE_TABLE.txt
3490,ZNF175,143,151,294,H929_H3K27ac_DEGREE_TABLE.txt
3491,ZNF217,152,113,265,H929_H3K27ac_DEGREE_TABLE.txt
3492,ZNF276,123,153,276,H929_H3K27ac_DEGREE_TABLE.txt
3493,ZNF283,133,153,286,H929_H3K27ac_DEGREE_TABLE.txt
3494,ZNF334,146,149,295,H929_H3K27ac_DEGREE_TABLE.txt
3495,ZNF335,144,151,295,H929_H3K27ac_DEGREE_TABLE.txt
3496,ZNF407,112,153,265,H929_H3K27ac_DEGREE_TABLE.txt
3497,ZNF48,149,146,295,H929_H3K27ac_DEGREE_TABLE.txt
3498,ZNF490,137,136,273,H929_H3K27ac_DEGREE_TABLE.txt
3499,ZNF516,137,120,257,H929_H3K27ac_DEGREE_TABLE.txt
3500,ZNF524,146,152,298,H929_H3K27ac_DEGREE_TABLE.txt
3501,ZNF580,146,150,296,H929_H3K27ac_DEGREE_TABLE.txt
3502,ZNF581,146,149,295,H929_H3K27ac_DEGREE_TABLE.txt
3503,ZNF592,129,90,219,H929_H3K27ac_DEGREE_TABLE.txt
3504,ZNF595,146,153,299,H929_H3K27ac_DEGREE_TABLE.txt
3505,ZNF652,150,152,302,H929_H3K27ac_DEGREE_TABLE.txt
3506,ZNF681,139,153,292,H929_H3K27ac_DEGREE_TABLE.txt
3507,ZNF688,133,131,264,H929_H3K27ac_DEGREE_TABLE.txt
3508,ZNF689,128,150,278,H929_H3K27ac_DEGREE_TABLE.txt
3509,ZNF718,146,152,298,H929_H3K27ac_DEGREE_TABLE.txt
3510,ZNF740,151,153,304,H929_H3K27ac_DEGREE_TABLE.txt
3511,ZNF76,138,151,289,H929_H3K27ac_DEGREE_TABLE.txt
3512,ZNF764,133,121,254,H929_H3K27ac_DEGREE_TABLE.txt
3513,ZNF768,133,153,286,H929_H3K27ac_DEGREE_TABLE.txt
3514,ZNF771,132,131,263,H929_H3K27ac_DEGREE_TABLE.txt
3515,ZNF775,135,151,286,H929_H3K27ac_DEGREE_TABLE.txt
3516,ZNF780A,140,152,292,H929_H3K27ac_DEGREE_TABLE.txt
3517,ZNF784,146,151,297,H929_H3K27ac_DEGREE_TABLE.txt
3518,ZNF785,133,123,256,H929_H3K27ac_DEGREE_TABLE.txt
3519,ZNF791,137,144,281,H929_H3K27ac_DEGREE_TABLE.txt
3520,AIRE,119,123,242,U266_H3K27ac_DEGREE_TABLE.txt
3521,ARID3A,102,120,222,U266_H3K27ac_DEGREE_TABLE.txt
3522,ARID5A,110,125,235,U266_H3K27ac_DEGREE_TABLE.txt
3523,ATF3,103,127,230,U266_H3K27ac_DEGREE_TABLE.txt
3524,ATF4,125,122,247,U266_H3K27ac_DEGREE_TABLE.txt
3525,ATF5,127,123,250,U266_H3K27ac_DEGREE_TABLE.txt
3526,BHLHE40,124,112,236,U266_H3K27ac_DEGREE_TABLE.txt
3527,BHLHE41,124,81,205,U266_H3K27ac_DEGREE_TABLE.txt
3528,CAD,97,121,218,U266_H3K27ac_DEGREE_TABLE.txt
3529,CAMTA2,121,24,145,U266_H3K27ac_DEGREE_TABLE.txt
3530,CEBPB,107,117,224,U266_H3K27ac_DEGREE_TABLE.txt
3531,CHD2,122,124,246,U266_H3K27ac_DEGREE_TABLE.txt
3532,CREB3L2,124,114,238,U266_H3K27ac_DEGREE_TABLE.txt
3533,CREB3L4,125,99,224,U266_H3K27ac_DEGREE_TABLE.txt
3534,CTCF,112,127,239,U266_H3K27ac_DEGREE_TABLE.txt
3535,CUX1,123,119,242,U266_H3K27ac_DEGREE_TABLE.txt
3536,DDIT3,118,115,233,U266_H3K27ac_DEGREE_TABLE.txt
3537,DMRTC2,121,90,211,U266_H3K27ac_DEGREE_TABLE.txt
3538,E2F2,127,125,252,U266_H3K27ac_DEGREE_TABLE.txt
3539,E2F3,118,127,245,U266_H3K27ac_DEGREE_TABLE.txt
3540,E2F4,124,118,242,U266_H3K27ac_DEGREE_TABLE.txt
3541,E2F6,114,127,241,U266_H3K27ac_DEGREE_TABLE.txt
3542,ELF2,108,113,221,U266_H3K27ac_DEGREE_TABLE.txt
3543,ELK3,113,98,211,U266_H3K27ac_DEGREE_TABLE.txt
3544,ERF,97,109,206,U266_H3K27ac_DEGREE_TABLE.txt
3545,FLI1,123,126,249,U266_H3K27ac_DEGREE_TABLE.txt
3546,FOSB,112,70,182,U266_H3K27ac_DEGREE_TABLE.txt
3547,FOSL1,117,113,230,U266_H3K27ac_DEGREE_TABLE.txt
3548,FOSL2,102,117,219,U266_H3K27ac_DEGREE_TABLE.txt
3549,FOXJ1,125,125,250,U266_H3K27ac_DEGREE_TABLE.txt
3550,FOXK2,121,111,232,U266_H3K27ac_DEGREE_TABLE.txt
3551,FOXN3,121,100,221,U266_H3K27ac_DEGREE_TABLE.txt
3552,GLI1,118,125,243,U266_H3K27ac_DEGREE_TABLE.txt
3553,HIVEP2,111,122,233,U266_H3K27ac_DEGREE_TABLE.txt
3554,HOMEZ,110,102,212,U266_H3K27ac_DEGREE_TABLE.txt
3555,HSF4,122,101,223,U266_H3K27ac_DEGREE_TABLE.txt
3556,IKZF1,118,126,244,U266_H3K27ac_DEGREE_TABLE.txt
3557,IKZF3,123,127,250,U266_H3K27ac_DEGREE_TABLE.txt
3558,IRF1,126,126,252,U266_H3K27ac_DEGREE_TABLE.txt
3559,IRF2,115,112,227,U266_H3K27ac_DEGREE_TABLE.txt
3560,IRF3,116,126,242,U266_H3K27ac_DEGREE_TABLE.txt
3561,IRF4,127,125,252,U266_H3K27ac_DEGREE_TABLE.txt
3562,IRF5,108,122,230,U266_H3K27ac_DEGREE_TABLE.txt
3563,IRF9,115,123,238,U266_H3K27ac_DEGREE_TABLE.txt
3564,IRX5,110,122,232,U266_H3K27ac_DEGREE_TABLE.txt
3565,JUNB,122,120,242,U266_H3K27ac_DEGREE_TABLE.txt
3566,KLF1,124,127,251,U266_H3K27ac_DEGREE_TABLE.txt
3567,KLF10,124,127,251,U266_H3K27ac_DEGREE_TABLE.txt
3568,KLF11,107,125,232,U266_H3K27ac_DEGREE_TABLE.txt
3569,KLF13,118,108,226,U266_H3K27ac_DEGREE_TABLE.txt
3570,KLF16,121,127,248,U266_H3K27ac_DEGREE_TABLE.txt
3571,KLF3,116,126,242,U266_H3K27ac_DEGREE_TABLE.txt
3572,KLF6,120,121,241,U266_H3K27ac_DEGREE_TABLE.txt
3573,KLF9,121,126,247,U266_H3K27ac_DEGREE_TABLE.txt
3574,MAFF,127,127,254,U266_H3K27ac_DEGREE_TABLE.txt
3575,MAZ,122,127,249,U266_H3K27ac_DEGREE_TABLE.txt
3576,MEF2B,123,125,248,U266_H3K27ac_DEGREE_TABLE.txt
3577,MEF2D,125,126,251,U266_H3K27ac_DEGREE_TABLE.txt
3578,MLX,127,88,215,U266_H3K27ac_DEGREE_TABLE.txt
3579,MYBL2,125,104,229,U266_H3K27ac_DEGREE_TABLE.txt
3580,MYCL1,122,97,219,U266_H3K27ac_DEGREE_TABLE.txt
3581,MYNN,112,102,214,U266_H3K27ac_DEGREE_TABLE.txt
3582,MZF1,106,127,233,U266_H3K27ac_DEGREE_TABLE.txt
3583,NFE2L1,125,112,237,U266_H3K27ac_DEGREE_TABLE.txt
3584,NFE2L2,97,118,215,U266_H3K27ac_DEGREE_TABLE.txt
3585,NFE2L3,125,126,251,U266_H3K27ac_DEGREE_TABLE.txt
3586,NFIB,113,119,232,U266_H3K27ac_DEGREE_TABLE.txt
3587,NFIL3,121,114,235,U266_H3K27ac_DEGREE_TABLE.txt
3588,NFIX,123,123,246,U266_H3K27ac_DEGREE_TABLE.txt
3589,NR1D1,126,124,250,U266_H3K27ac_DEGREE_TABLE.txt
3590,NR1I3,125,103,228,U266_H3K27ac_DEGREE_TABLE.txt
3591,NR3C1,94,121,215,U266_H3K27ac_DEGREE_TABLE.txt
3592,NR6A1,120,109,229,U266_H3K27ac_DEGREE_TABLE.txt
3593,ONECUT2,124,112,236,U266_H3K27ac_DEGREE_TABLE.txt
3594,PBX4,114,111,225,U266_H3K27ac_DEGREE_TABLE.txt
3595,PIF1,127,101,228,U266_H3K27ac_DEGREE_TABLE.txt
3596,PKNOX1,90,124,214,U266_H3K27ac_DEGREE_TABLE.txt
3597,POU2F1,102,126,228,U266_H3K27ac_DEGREE_TABLE.txt
3598,POU2F2,123,127,250,U266_H3K27ac_DEGREE_TABLE.txt
3599,POU3F1,122,125,247,U266_H3K27ac_DEGREE_TABLE.txt
3600,POU5F1,116,125,241,U266_H3K27ac_DEGREE_TABLE.txt
3601,PRDM1,125,127,252,U266_H3K27ac_DEGREE_TABLE.txt
3602,PRDM15,113,127,240,U266_H3K27ac_DEGREE_TABLE.txt
3603,RARA,121,127,248,U266_H3K27ac_DEGREE_TABLE.txt
3604,RARG,116,127,243,U266_H3K27ac_DEGREE_TABLE.txt
3605,RORA,127,126,253,U266_H3K27ac_DEGREE_TABLE.txt
3606,RUNX1,124,120,244,U266_H3K27ac_DEGREE_TABLE.txt
3607,SIN3A,109,127,236,U266_H3K27ac_DEGREE_TABLE.txt
3608,SMAD7,122,115,237,U266_H3K27ac_DEGREE_TABLE.txt
3609,SNAI3,119,123,242,U266_H3K27ac_DEGREE_TABLE.txt
3610,SOX11,110,127,237,U266_H3K27ac_DEGREE_TABLE.txt
3611,SP3,103,127,230,U266_H3K27ac_DEGREE_TABLE.txt
3612,STAT1,120,127,247,U266_H3K27ac_DEGREE_TABLE.txt
3613,STAT2,115,126,241,U266_H3K27ac_DEGREE_TABLE.txt
3614,TCF3,111,127,238,U266_H3K27ac_DEGREE_TABLE.txt
3615,TFAP4,103,116,219,U266_H3K27ac_DEGREE_TABLE.txt
3616,THAP11,111,120,231,U266_H3K27ac_DEGREE_TABLE.txt
3617,THRA,126,127,253,U266_H3K27ac_DEGREE_TABLE.txt
3618,XBP1,126,104,230,U266_H3K27ac_DEGREE_TABLE.txt
3619,ZBTB38,126,118,244,U266_H3K27ac_DEGREE_TABLE.txt
3620,ZBTB7B,124,120,244,U266_H3K27ac_DEGREE_TABLE.txt
3621,ZFP1,114,127,241,U266_H3K27ac_DEGREE_TABLE.txt
3622,ZFP62,125,127,252,U266_H3K27ac_DEGREE_TABLE.txt
3623,ZFP91,119,122,241,U266_H3K27ac_DEGREE_TABLE.txt
3624,ZNF114,118,103,221,U266_H3K27ac_DEGREE_TABLE.txt
3625,ZNF132,110,127,237,U266_H3K27ac_DEGREE_TABLE.txt
3626,ZNF217,125,101,226,U266_H3K27ac_DEGREE_TABLE.txt
3627,ZNF3,109,110,219,U266_H3K27ac_DEGREE_TABLE.txt
3628,ZNF334,115,120,235,U266_H3K27ac_DEGREE_TABLE.txt
3629,ZNF48,123,126,249,U266_H3K27ac_DEGREE_TABLE.txt
3630,ZNF483,110,125,235,U266_H3K27ac_DEGREE_TABLE.txt
3631,ZNF497,110,125,235,U266_H3K27ac_DEGREE_TABLE.txt
3632,ZNF574,123,127,250,U266_H3K27ac_DEGREE_TABLE.txt
3633,ZNF584,110,119,229,U266_H3K27ac_DEGREE_TABLE.txt
3634,ZNF592,101,70,171,U266_H3K27ac_DEGREE_TABLE.txt
3635,ZNF652,123,127,250,U266_H3K27ac_DEGREE_TABLE.txt
3636,ZNF680,121,127,248,U266_H3K27ac_DEGREE_TABLE.txt
3637,ZNF688,117,99,216,U266_H3K27ac_DEGREE_TABLE.txt
3638,ZNF689,121,126,247,U266_H3K27ac_DEGREE_TABLE.txt
3639,ZNF740,116,127,243,U266_H3K27ac_DEGREE_TABLE.txt
3640,ZNF764,117,94,211,U266_H3K27ac_DEGREE_TABLE.txt
3641,ZNF768,117,127,244,U266_H3K27ac_DEGREE_TABLE.txt
3642,ZNF771,111,106,217,U266_H3K27ac_DEGREE_TABLE.txt
3643,ZNF785,117,99,216,U266_H3K27ac_DEGREE_TABLE.txt
3644,ZNF79,114,123,237,U266_H3K27ac_DEGREE_TABLE.txt
3645,ZNF837,110,126,236,U266_H3K27ac_DEGREE_TABLE.txt
3646,ZNF846,112,114,226,U266_H3K27ac_DEGREE_TABLE.txt
3647,ARF1,122,53,175,MM10_jia_DEGREE_TABLE.txt
3648,ARF4,120,71,191,MM10_jia_DEGREE_TABLE.txt
3649,ATF3,114,128,242,MM10_jia_DEGREE_TABLE.txt
3650,ATF5,122,122,244,MM10_jia_DEGREE_TABLE.txt
3651,ATF6,120,90,210,MM10_jia_DEGREE_TABLE.txt
3652,BACH1,117,100,217,MM10_jia_DEGREE_TABLE.txt
3653,BCL11A,117,127,244,MM10_jia_DEGREE_TABLE.txt
3654,BCL6B,110,128,238,MM10_jia_DEGREE_TABLE.txt
3655,BCLAF1,118,126,244,MM10_jia_DEGREE_TABLE.txt
3656,BHLHE41,124,74,198,MM10_jia_DEGREE_TABLE.txt
3657,BRCA1,110,72,182,MM10_jia_DEGREE_TABLE.txt
3658,CAMTA2,118,47,165,MM10_jia_DEGREE_TABLE.txt
3659,CEBPB,113,109,222,MM10_jia_DEGREE_TABLE.txt
3660,CEBPG,109,108,217,MM10_jia_DEGREE_TABLE.txt
3661,CHD2,126,125,251,MM10_jia_DEGREE_TABLE.txt
3662,CREB3L2,125,111,236,MM10_jia_DEGREE_TABLE.txt
3663,CREB3L4,119,102,221,MM10_jia_DEGREE_TABLE.txt
3664,DDIT3,116,121,237,MM10_jia_DEGREE_TABLE.txt
3665,DMRTA1,103,80,183,MM10_jia_DEGREE_TABLE.txt
3666,ELF1,120,127,247,MM10_jia_DEGREE_TABLE.txt
3667,ELF2,102,112,214,MM10_jia_DEGREE_TABLE.txt
3668,ERF,95,108,203,MM10_jia_DEGREE_TABLE.txt
3669,ESRRA,89,128,217,MM10_jia_DEGREE_TABLE.txt
3670,FIZ1,99,128,227,MM10_jia_DEGREE_TABLE.txt
3671,FOXO3,117,124,241,MM10_jia_DEGREE_TABLE.txt
3672,FOXP1,100,127,227,MM10_jia_DEGREE_TABLE.txt
3673,FOXP2,114,113,227,MM10_jia_DEGREE_TABLE.txt
3674,GZF1,121,48,169,MM10_jia_DEGREE_TABLE.txt
3675,HAP1,117,20,137,MM10_jia_DEGREE_TABLE.txt
3676,HBP1,109,121,230,MM10_jia_DEGREE_TABLE.txt
3677,HEY2,118,93,211,MM10_jia_DEGREE_TABLE.txt
3678,HINFP,118,123,241,MM10_jia_DEGREE_TABLE.txt
3679,HIVEP2,117,122,239,MM10_jia_DEGREE_TABLE.txt
3680,IKZF1,120,123,243,MM10_jia_DEGREE_TABLE.txt
3681,IKZF3,127,128,255,MM10_jia_DEGREE_TABLE.txt
3682,IRF1,121,127,248,MM10_jia_DEGREE_TABLE.txt
3683,IRF2,124,105,229,MM10_jia_DEGREE_TABLE.txt
3684,IRF3,118,127,245,MM10_jia_DEGREE_TABLE.txt
3685,IRF4,125,121,246,MM10_jia_DEGREE_TABLE.txt
3686,IRF9,110,118,228,MM10_jia_DEGREE_TABLE.txt
3687,JUNB,117,116,233,MM10_jia_DEGREE_TABLE.txt
3688,JUND,106,128,234,MM10_jia_DEGREE_TABLE.txt
3689,KLF1,123,127,250,MM10_jia_DEGREE_TABLE.txt
3690,KLF13,127,111,238,MM10_jia_DEGREE_TABLE.txt
3691,KLF16,116,127,243,MM10_jia_DEGREE_TABLE.txt
3692,KLF2,115,124,239,MM10_jia_DEGREE_TABLE.txt
3693,KLF6,115,122,237,MM10_jia_DEGREE_TABLE.txt
3694,KLF9,120,126,246,MM10_jia_DEGREE_TABLE.txt
3695,MAZ,124,127,251,MM10_jia_DEGREE_TABLE.txt
3696,MEF2C,127,122,249,MM10_jia_DEGREE_TABLE.txt
3697,MEF2D,124,118,242,MM10_jia_DEGREE_TABLE.txt
3698,MYBL2,114,94,208,MM10_jia_DEGREE_TABLE.txt
3699,MYNN,116,96,212,MM10_jia_DEGREE_TABLE.txt
3700,MZF1,115,128,243,MM10_jia_DEGREE_TABLE.txt
3701,NFE2,113,99,212,MM10_jia_DEGREE_TABLE.txt
3702,NFE2L1,125,111,236,MM10_jia_DEGREE_TABLE.txt
3703,NFE2L2,124,104,228,MM10_jia_DEGREE_TABLE.txt
3704,NFE2L3,122,122,244,MM10_jia_DEGREE_TABLE.txt
3705,NFIL3,117,97,214,MM10_jia_DEGREE_TABLE.txt
3706,NFIX,123,122,245,MM10_jia_DEGREE_TABLE.txt
3707,NFKB1,96,128,224,MM10_jia_DEGREE_TABLE.txt
3708,NFKB2,106,125,231,MM10_jia_DEGREE_TABLE.txt
3709,NHLH1,107,125,232,MM10_jia_DEGREE_TABLE.txt
3710,NR3C1,120,119,239,MM10_jia_DEGREE_TABLE.txt
3711,NR4A2,118,127,245,MM10_jia_DEGREE_TABLE.txt
3712,PAX4,119,128,247,MM10_jia_DEGREE_TABLE.txt
3713,PBX2,105,95,200,MM10_jia_DEGREE_TABLE.txt
3714,PBX4,113,103,216,MM10_jia_DEGREE_TABLE.txt
3715,PLAGL2,109,128,237,MM10_jia_DEGREE_TABLE.txt
3716,POU2F1,108,127,235,MM10_jia_DEGREE_TABLE.txt
3717,POU5F1,114,123,237,MM10_jia_DEGREE_TABLE.txt
3718,PRDM1,128,126,254,MM10_jia_DEGREE_TABLE.txt
3719,PRDM10,95,90,185,MM10_jia_DEGREE_TABLE.txt
3720,PRDM14,109,124,233,MM10_jia_DEGREE_TABLE.txt
3721,RAX2,97,66,163,MM10_jia_DEGREE_TABLE.txt
3722,RFX1,97,128,225,MM10_jia_DEGREE_TABLE.txt
3723,RFX3,114,126,240,MM10_jia_DEGREE_TABLE.txt
3724,RFX5,108,128,236,MM10_jia_DEGREE_TABLE.txt
3725,RFX7,107,71,178,MM10_jia_DEGREE_TABLE.txt
3726,RUNX1,120,111,231,MM10_jia_DEGREE_TABLE.txt
3727,RXRB,117,128,245,MM10_jia_DEGREE_TABLE.txt
3728,SF1,116,106,222,MM10_jia_DEGREE_TABLE.txt
3729,SIN3A,114,128,242,MM10_jia_DEGREE_TABLE.txt
3730,SP1,111,128,239,MM10_jia_DEGREE_TABLE.txt
3731,SP3,105,127,232,MM10_jia_DEGREE_TABLE.txt
3732,STAT2,109,125,234,MM10_jia_DEGREE_TABLE.txt
3733,TBP,105,128,233,MM10_jia_DEGREE_TABLE.txt
3734,TCF12,117,127,244,MM10_jia_DEGREE_TABLE.txt
3735,TCF3,112,128,240,MM10_jia_DEGREE_TABLE.txt
3736,TCF4,119,127,246,MM10_jia_DEGREE_TABLE.txt
3737,THAP1,122,128,250,MM10_jia_DEGREE_TABLE.txt
3738,USF1,109,118,227,MM10_jia_DEGREE_TABLE.txt
3739,XBP1,122,103,225,MM10_jia_DEGREE_TABLE.txt
3740,ZBTB1,120,101,221,MM10_jia_DEGREE_TABLE.txt
3741,ZBTB11,117,128,245,MM10_jia_DEGREE_TABLE.txt
3742,ZBTB20,114,102,216,MM10_jia_DEGREE_TABLE.txt
3743,ZBTB32,114,92,206,MM10_jia_DEGREE_TABLE.txt
3744,ZBTB38,127,109,236,MM10_jia_DEGREE_TABLE.txt
3745,ZBTB7A,114,125,239,MM10_jia_DEGREE_TABLE.txt
3746,ZBTB7B,127,128,255,MM10_jia_DEGREE_TABLE.txt
3747,ZFP91,120,121,241,MM10_jia_DEGREE_TABLE.txt
3748,ZNF114,116,104,220,MM10_jia_DEGREE_TABLE.txt
3749,ZNF143,102,124,226,MM10_jia_DEGREE_TABLE.txt
3750,ZNF16,103,128,231,MM10_jia_DEGREE_TABLE.txt
3751,ZNF184,107,128,235,MM10_jia_DEGREE_TABLE.txt
3752,ZNF215,89,123,212,MM10_jia_DEGREE_TABLE.txt
3753,ZNF217,121,73,194,MM10_jia_DEGREE_TABLE.txt
3754,ZNF219,117,127,244,MM10_jia_DEGREE_TABLE.txt
3755,ZNF250,115,128,243,MM10_jia_DEGREE_TABLE.txt
3756,ZNF335,96,122,218,MM10_jia_DEGREE_TABLE.txt
3757,ZNF460,114,128,242,MM10_jia_DEGREE_TABLE.txt
3758,ZNF490,108,114,222,MM10_jia_DEGREE_TABLE.txt
3759,ZNF497,112,123,235,MM10_jia_DEGREE_TABLE.txt
3760,ZNF524,99,128,227,MM10_jia_DEGREE_TABLE.txt
3761,ZNF526,95,127,222,MM10_jia_DEGREE_TABLE.txt
3762,ZNF543,114,127,241,MM10_jia_DEGREE_TABLE.txt
3763,ZNF579,99,125,224,MM10_jia_DEGREE_TABLE.txt
3764,ZNF580,115,122,237,MM10_jia_DEGREE_TABLE.txt
3765,ZNF581,115,115,230,MM10_jia_DEGREE_TABLE.txt
3766,ZNF584,112,118,230,MM10_jia_DEGREE_TABLE.txt
3767,ZNF672,118,127,245,MM10_jia_DEGREE_TABLE.txt
3768,ZNF687,120,69,189,MM10_jia_DEGREE_TABLE.txt
3769,ZNF689,110,124,234,MM10_jia_DEGREE_TABLE.txt
3770,ZNF692,118,126,244,MM10_jia_DEGREE_TABLE.txt
3771,ZNF784,115,117,232,MM10_jia_DEGREE_TABLE.txt
3772,ZNF791,108,111,219,MM10_jia_DEGREE_TABLE.txt
3773,ZNF805,114,123,237,MM10_jia_DEGREE_TABLE.txt
3774,ZNF837,112,128,240,MM10_jia_DEGREE_TABLE.txt
